"[""-"", ""entities""]"	"[""-"", ""attributes of government""]"	ATTRIBUTES OF GOVERNMENT ARE ENTITIES
"[""Access to an object"", ""access to an object"", ""Access""]"	"[""Access to education"", ""access to education""]"	ACCESS TO EDUCATION IS ACCESS TO AN OBJECT
"[""Access to an object"", ""access to an object"", ""Access""]"	"[""Access to knowledge"", ""access to knowledge""]"	ACCESS TO KNOWLEDGE IS ACCESS TO AN OBJECT
"[""Actor"", ""actor""]"	"[""Market"", ""market"", ""Institution"", ""Organization"", ""Social group"", ""Group""]"	MARKET IS AN ACTOR
"[""Addiction"", ""drugs"", ""Physical affliction"", ""Psychological fixation"", ""targets of psychological fixation"", ""Harm to living entity"", ""Physical harm"", ""Harm"", ""Causation"", ""Complex_process""]"	"[""Personal weapon"", ""guns"", ""Complex physical object"", ""Object"", ""Bounded entity"", ""Physical entity"", ""Entity""]"	GUNS ARE DRUGS
"[""Adoption"", ""adoption"", ""Selection""]"	"[""Selection"", ""selection"", ""Choosing""]"	SELECTION IS ADOPTION
"[""Agentive causation"", ""agent""]"	"[""Natural process"", ""nature"", ""Process""]"	NATURE IS AN AGENT
"[""Agentive causation"", ""agentive causation""]"	"[""Causation"", ""causation"", ""Complex_process""]"	CAUSATION IS AGENTIVE CAUSATION
"[""Aid to upward motion"", ""aid to upward motion"", ""Aids to motion"", ""aids to reaching a destination"", ""Enablement""]"	"[""Improving economic status"", ""aids to improving economic status"", ""Change of state"", ""Improving a state"", ""Aids to action"", ""aids to achieving a purpose"", ""Experiencing_a_state"", ""Process""]"	AIDS TO IMPROVING ECONOMIC STATUS IS AID TO UPWARD MOTION
"[""Aids to motion"", ""aids to reaching a destination"", ""Enablement""]"	"[""Aids to action"", ""aids to achieving a purpose""]"	AIDS TO ACHIEVING A PURPOSE ARE AIDS TO REACHING A DESTINATION
"[""Animal"", ""animals"", ""Animate entity"", ""Biological entity"", ""Complex physical object"", ""Object"", ""Bounded entity"", ""Physical entity"", ""Entity""]"	"[""Person"", ""people"", ""Animate entity"", ""Sentient entity"", ""Biological entity"", ""Entity"", ""Complex physical object"", ""Object"", ""Bounded entity"", ""Physical entity""]"	PEOPLE ARE ANIMALS
"[""Animal"", ""controlling an animal"", ""Animate entity"", ""Biological entity"", ""Complex physical object"", ""Object"", ""Bounded entity"", ""Physical entity"", ""Entity""]"	"[""Crime"", ""addressing crime""]"	ADDRESSING CRIME IS CONTROLLING AN ANIMAL
"[""Animal"", ""rampaging animal"", ""Animate entity"", ""Biological entity"", ""Complex physical object"", ""Object"", ""Bounded entity"", ""Physical entity"", ""Entity""]"	"[""Crime"", ""uncontrolled crime"", ""Committing_crime""]"	UNCONTROLLED CRIME IS A RAMPAGING ANIMAL
"[""Animate entity"", ""animate entities"", ""Biological entity"", ""Complex physical object"", ""Object"", ""Bounded entity"", ""Physical entity"", ""Entity""]"	"[""Social problems"", ""social problems"", ""Problem""]"	SOCIAL PROBLEMS ARE ANIMATE ENTITIES
"[""Animate entity"", ""living entities"", ""Biological entity"", ""Complex physical object"", ""Object"", ""Bounded entity"", ""Physical entity"", ""Entity""]"	"[""Business"", ""businesses""]"	BUSINESSES ARE LIVING ENTITIES
"[""Animate entity"", ""living entities"", ""Biological entity"", ""Complex physical object"", ""Object"", ""Bounded entity"", ""Physical entity"", ""Entity""]"	"[""Law"", ""laws""]"	LAWS ARE LIVING ENTITIES
"[""Antagonistic force"", ""antagonistic force"", ""Force-application"", ""antagonistic forces"", ""Action"", ""Force-Dynamic Interaction"", ""Process"", ""Complex process""]"	"[""Educational opportunities"", ""impediments to utilizing educational opportunities"", ""Opportunities"", ""Difficulties in action"", ""impediments to action""]"	IMPEDIMENTS TO UTILIZING EDUCATIONAL OPPORTUNITIES IS ANTAGONISTIC FORCE
"[""Antagonistic force"", ""antagonistic force"", ""Force-application"", ""antagonistic forces"", ""Action"", ""Force-Dynamic Interaction"", ""Process"", ""Complex process""]"	"[""Improving economic status"", ""impediments to improving economic status"", ""Change of state"", ""Improving a state"", ""Difficulties in action"", ""impediments to action"", ""Experiencing_a_state"", ""Process""]"	IMPEDIMENTS TO IMPROVING ECONOMIC STATUS IS ANTAGONISTIC FORCE
"[""Antagonistic force"", ""antagonistic forces"", ""Force-application"", ""Action"", ""Force-Dynamic Interaction"", ""Process"", ""Complex process""]"	"[""Difficulties in action"", ""impediments to action""]"	IMPEDIMENTS TO ACTION ARE ANTAGONISTIC FORCES
"[""Attacking"", ""attacking"", ""Harm to living entity"", ""Physical harm"", ""Harm"", ""Causation"", ""Complex_process""]"	"[""Criticizing"", ""criticizing""]"	CRITICIZING IS ATTACKING
"[""Attacking"", ""attacking"", ""Harm to living entity"", ""Physical harm"", ""Harm"", ""Causation"", ""Complex_process""]"	"[""Rights"", ""government's harmful treatment of rights""]"	GOVERNMENT'S HARMFUL TREATMENT OF RIGHTS IS ATTACKING
"[""Attacking"", ""harming cancer"", ""Attack"", ""Harm to living entity"", ""Physical harm"", ""Harm"", ""Causation"", ""Complex_process""]"	"[""Cancer"", ""surviving cancer"", ""Disease"", ""Physical affliction"", ""Harm to living entity"", ""Physical harm"", ""Harm"", ""Causation"", ""Complex_process""]"	SURVIVING CANCER IS HARMING CANCER
"[""Avoiding obstacles"", ""avoiding obstacles"", ""Motion with respect to an undesirable entity""]"	"[""Taxation"", ""not paying taxes"", ""Governing action"", ""Purposeful action"", ""Action"", ""Process""]"	NOT PAYING TAXES IS AVOIDING OBSTACLES
"[""Back"", ""behind"", ""Figure ground"", ""Spatial relation""]"	"[""Time"", ""past""]"	PAST IS BEHIND
"[""Barrier to accessing a location"", ""barrier to accessing a location"", ""Barrier"", ""Scale"", ""linear spatial scale"", ""Motion-affecting properties of the landscape"", ""State"", ""Motion-affecting external factors"", ""Motion impediments"", ""Impediment to motion"", ""Affected motion"", ""Causation"", ""Complex_process""]"	"[""Financial resource"", ""insurmountable differences in wealth"", ""Resource"", ""Wealth"", ""wealth"", ""Economic status"", ""Social group"", ""Status"", ""Group""]"	INSURMOUNTABLE DIFFERENCES IN WEALTH IS BARRIER TO ACCESSING A LOCATION
"[""Barrier to accessing a location"", ""obstacles to accessing a location"", ""Barrier"", ""Motion impediments"", ""impediments to movement"", ""Location"", ""locations"", ""Motion-affecting properties of the landscape"", ""Impediment to motion"", ""Motion-affecting external factors"", ""Affected motion"", ""Causation"", ""Complex_process""]"	"[""Educational opportunities"", ""impediments to utilizing educational opportunities"", ""Opportunities"", ""Difficulties in action"", ""difficulties"", ""opportunities""]"	IMPEDIMENTS TO UTILIZING EDUCATIONAL OPPORTUNITIES IS OBSTACLES TO ACCESSING A LOCATION
"[""Barrier"", ""barrier"", ""Having_or_lacking_access"", ""Motion-affecting properties of the landscape"", ""Motion-affecting external factors"", ""Motion impediments"", ""Impediment to motion"", ""Affected motion"", ""Causation"", ""Complex_process""]"	"[""Regulation"", ""government regulation""]"	GOVERNMENT REGULATION IS A BARRIER
"[""Being at a High Location"", ""being at a high location"", ""Being at a location"", ""Scale"", ""point on a scale"", ""Trajector landmark"", ""Process"", ""Figure ground"", ""Spatial relation"", ""State""]"	"[""Wealth"", ""being wealthy"", ""Economic status"", ""economic status"", ""Social group"", ""Status"", ""Experiencing a state"", ""being in a state"", ""Group""]"	BEING WEALTHY IS BEING AT A HIGH LOCATION
"[""Being at a High Location"", ""up"", ""Being at a location"", ""Trajector landmark"", ""Process"", ""Figure ground"", ""Spatial relation""]"	"[""Happiness"", ""happy"", ""Emotion"", ""Experiencing a state""]"	HAPPY IS UP
"[""Being at a High Location"", ""up"", ""Being at a location"", ""Trajector landmark"", ""Process"", ""Figure ground"", ""Spatial relation""]"	"[""Health"", ""health"", ""Well-being""]"	HEALTH IS UP
"[""Being at a location"", ""being at a location"", ""Trajector landmark"", ""Process"", ""Figure ground"", ""Spatial relation""]"	"[""Experiencing an economic status"", ""experiencing an economic status"", ""Experiencing a state"", ""experiencing a state""]"	EXPERIENCING AN ECONOMIC STATUS IS BEING AT A LOCATION
"[""Being at a location"", ""being at a location"", ""Trajector landmark"", ""Process"", ""Spatial relation"", ""spatial relation with an entity"", ""Figure ground""]"	"[""Experiencing a state"", ""experiencing a state""]"	EXPERIENCING A STATE IS BEING AT A LOCATION
"[""Being at a location"", ""being in a location"", ""Trajector landmark"", ""Process"", ""Figure ground"", ""Spatial relation""]"	"[""Action"", ""action"", ""Process""]"	ACTION IS BEING IN A LOCATION
"[""Being at a location"", ""being physically at this location"", ""Trajector landmark"", ""Process"", ""Figure ground"", ""Spatial relation""]"	"[""Existence"", ""existing"", ""Process""]"	EXISTING IS BEING PHYSICALLY AT THIS LOCATION
"[""Being at a location"", ""being physically at this location"", ""Trajector landmark"", ""Process"", ""Figure ground"", ""Spatial relation""]"	"[""Life cycle"", ""being alive"", ""Cycle"", ""Existence"", ""existing"", ""Process""]"	BEING ALIVE IS BEING PHYSICALLY AT THIS LOCATION
"[""Being at a location"", ""here"", ""Trajector landmark"", ""Process"", ""physical co-location"", ""Figure ground"", ""Spatial relation""]"	"[""Time"", ""now"", ""simultaneity""]"	NOW IS HERE
"[""Being at a Low Location"", ""being at a low location"", ""Being at a location"", ""Being in a Bounded Region"", ""being in a bounded region"", ""Trajector landmark"", ""Process"", ""Figure ground"", ""Spatial relation"", ""being at a location"", ""spatial relation with an entity""]"	"[""Impoverished"", ""being impoverished"", ""Experiencing a negative state"", ""Experiencing an economic status"", ""Experiencing a state""]"	BEING IMPOVERISHED IS BEING AT A LOW LOCATION
"[""Being at a Low Location"", ""down"", ""Being at a location"", ""Trajector landmark"", ""Process"", ""Figure ground"", ""Spatial relation""]"	"[""Health"", ""sickness"", ""Health_response"", ""Well-being""]"	SICKNESS IS DOWN
"[""Being at a Low Location"", ""down"", ""Being at a location"", ""Trajector landmark"", ""Process"", ""Figure ground"", ""Spatial relation""]"	"[""Sadness"", ""sad"", ""Emotion_directed"", ""Emotion"", ""Experiencing a state""]"	SAD IS DOWN
"[""Being high on a scale"", ""being high on a scale""]"	"[""Social class"", ""being in a high social class"", ""Economic status"", ""economic status"", ""Social group"", ""Status"", ""Experiencing a state"", ""being in a state"", ""Group""]"	BEING IN A HIGH SOCIAL CLASS IS BEING HIGH ON A SCALE
"[""Being in a Bounded Region"", ""being in a bounded region"", ""Being at a location"", ""being at a location"", ""Trajector landmark"", ""Process"", ""Spatial relation"", ""spatial relation with an entity"", ""Figure ground""]"	"[""Impoverished"", ""being impoverished"", ""Experiencing a negative state"", ""Experiencing an economic status"", ""Experiencing a state"", ""experiencing a state""]"	BEING IMPOVERISHED IS BEING IN A BOUNDED REGION
"[""Being in the middle of a scale"", ""being in the middle of a scale"", ""Scale"", ""point on a scale"", ""State""]"	"[""Social class"", ""being in a middle class"", ""Economic status"", ""economic status"", ""Social group"", ""Status"", ""Experiencing a state"", ""being in a state"", ""Group""]"	BEING IN A MIDDLE CLASS IS BEING IN THE MIDDLE OF A SCALE
"[""Being low on a scale"", ""being low on a scale"", ""Scale"", ""State""]"	"[""Social class"", ""being in a low social class"", ""Economic status"", ""economic status"", ""Social group"", ""Status"", ""Experiencing a state"", ""being in a state"", ""Group""]"	BEING IN A LOW SOCIAL CLASS IS BEING LOW ON A SCALE
"[""Biological entity"", ""living entities"", ""Biological_entity"", ""Complex physical object"", ""Object"", ""Bounded entity"", ""Physical entity"", ""Entity""]"	"[""Ideology"", ""political ideologies""]"	POLITICAL IDEOLOGIES ARE LIVING ENTITIES
"[""Biological entity"", ""living entity"", ""Complex physical object"", ""Object"", ""Bounded entity"", ""Physical entity"", ""Entity""]"	"[""Gun law decision-making"", ""gun debate""]"	GUN DEBATE IS A LIVING ENTITY
"[""Biological entity"", ""organism"", ""Complex physical object"", ""complex physical object"", ""Object"", ""Bounded entity"", ""Physical entity"", ""Entity""]"	"[""Institution"", ""institution"", ""Organization"", ""Social group"", ""Group""]"	INSTITUTION IS AN ORGANISM
"[""Biological entity"", ""organism"", ""Complex physical object"", ""Object"", ""Bounded entity"", ""Physical entity"", ""Entity""]"	"[""Debt"", ""debt""]"	DEBT IS AN ORGANISM
"[""Biological entity"", ""organism"", ""Complex physical object"", ""Object"", ""Bounded entity"", ""Physical entity"", ""Entity""]"	"[""Government institution"", ""government"", ""Government_institution"", ""Institution"", ""institution"", ""Organization"", ""Social group"", ""Group""]"	GOVERNMENT IS AN ORGANISM
"[""Biological entity"", ""organisms"", ""Complex physical object"", ""complex physical objects"", ""Object"", ""Bounded entity"", ""Physical entity"", ""Entity""]"	"[""Ideology"", ""ideologies""]"	IDEOLOGIES ARE ORGANISMS
"[""Bird"", ""bird"", ""Animal"", ""Animate entity"", ""Biological entity"", ""Complex physical object"", ""Object"", ""Bounded entity"", ""Physical entity"", ""Entity""]"	"[""Democracy"", ""democracy""]"	DEMOCRACY IS A BIRD
"[""Boat motion x-schema"", ""path of boat""]"	"[""Nation"", ""future of a nation"", ""Political region""]"	FUTURE OF A NATION IS PATH OF BOAT
"[""Boat"", ""boat"", ""Vehicle"", ""Operate_vehicle"", ""Seafaring_vehicle""]"	"[""Nation"", ""nation"", ""Political region""]"	NATION IS A BOAT
"[""Bodily functioning"", ""body""]"	"[""Cognizing"", ""mind""]"	MIND IS A BODY
"[""Body weight"", ""body weight"", ""Weight""]"	"[""Resource"", ""amount of resource""]"	AMOUNT OF RESOURCE IS BODY WEIGHT
"[""Body"", ""body"", ""Observable_body_parts""]"	"[""Nation"", ""nation"", ""Political region""]"	NATION IS A BODY
"[""Body"", ""body"", ""Physical structure"", ""physical structure"", ""Complex physical object"", ""Object"", ""Bounded entity"", ""Physical entity"", ""Entity""]"	"[""Government institution"", ""government institution"", ""Institution"", ""Organization"", ""Social group"", ""Group""]"	GOVERNMENT INSTITUTION IS A BODY
"[""Body"", ""body""]"	"[""Economy"", ""economy"", ""Society"", ""society""]"	ECONOMY IS A BODY
"[""Body"", ""body""]"	"[""Group"", ""group""]"	GROUP IS A BODY
"[""Body"", ""healthy body""]"	"[""Government institution"", ""effective government institution"", ""Institution"", ""Organization"", ""Social group"", ""Group""]"	EFFECTIVE GOVERNMENT INSTITUTION IS A HEALTHY BODY
"[""Body"", ""lean body""]"	"[""Government institution"", ""efficient government"", ""Institution"", ""Organization"", ""Social group"", ""Group""]"	EFFICIENT GOVERNMENT IS A LEAN BODY
"[""Bounded region"", ""bounded region in space"", ""Region""]"	"[""Relationship"", ""relationship""]"	RELATIONSHIP IS A BOUNDED REGION IN SPACE
"[""Bounded region"", ""bounded region"", ""Region""]"	"[""Control"", ""control"", ""Complex process""]"	CONTROL IS A BOUNDED REGION
"[""Bounded region"", ""bounded region"", ""Region""]"	"[""Social group"", ""social group"", ""Group""]"	SOCIAL GROUP IS A BOUNDED REGION
"[""Bounded region"", ""bounded regions in space"", ""Region""]"	"[""Activity"", ""activities""]"	ACTIVITIES ARE BOUNDED REGIONS IN SPACE
"[""Bounded region"", ""bounded regions"", ""Region""]"	"[""Category"", ""categories""]"	CATEGORIES ARE BOUNDED REGIONS
"[""Bounded region"", ""location along path"", ""Bounded_region"", ""Region""]"	"[""Nation"", ""state of nation"", ""Political region"", ""State"", ""states""]"	STATE OF NATION IS LOCATION ALONG PATH
"[""Building"", ""building"", ""Physical structure"", ""Complex physical object"", ""complex structure"", ""Object"", ""Bounded entity"", ""Physical entity"", ""Entity"", ""physical structure""]"	"[""Career"", ""career""]"	CAREER IS A BUILDING
"[""Building"", ""building"", ""Physical structure"", ""Complex physical object"", ""complex structure"", ""Object"", ""Bounded entity"", ""Physical entity"", ""Entity""]"	"[""Nation"", ""nation"", ""Political region""]"	NATION IS A BUILDING
"[""Building"", ""building"", ""Physical structure"", ""Complex physical object"", ""Object"", ""Bounded entity"", ""Physical entity"", ""Entity""]"	"[""Government legitimacy"", ""trust in government"", ""Legitimacy"", ""Trust relationship"", ""trust relationships"", ""Relationship"", ""relationships""]"	TRUST IN GOVERNMENT IS A BUILDING
"[""Building"", ""building"", ""Physical structure"", ""physical structure"", ""Complex physical object"", ""Object"", ""Bounded entity"", ""Physical entity"", ""Entity""]"	"[""Government institution"", ""government institution"", ""Institution"", ""institutions"", ""Organization"", ""Social group"", ""Group""]"	GOVERNMENT INSTITUTION IS A BUILDING
"[""Building"", ""building"", ""Physical structure"", ""physical structure"", ""Complex physical object"", ""Object"", ""Bounded entity"", ""Physical entity"", ""Entity""]"	"[""Mind"", ""mind""]"	MIND IS A BUILDING
"[""Building"", ""buildings"", ""Buildings"", ""Physical structure"", ""physical structures"", ""Complex physical object"", ""Object"", ""Bounded entity"", ""Physical entity"", ""Entity"", ""complex structures"", ""objects""]"	"[""Trust relationship"", ""trust relationships"", ""Relationship"", ""relationships"", ""Relation_between_individuals""]"	TRUST RELATIONSHIPS ARE BUILDINGS
"[""Building"", ""buildings"", ""Physical structure"", ""Complex physical object"", ""complex physical object"", ""Object"", ""Bounded entity"", ""Physical entity"", ""Entity""]"	"[""Institution"", ""institutions"", ""Organization"", ""Social group"", ""Group""]"	INSTITUTIONS ARE BUILDINGS
"[""Building"", ""buildings"", ""Physical structure"", ""Complex physical object"", ""complex structures"", ""Object"", ""Bounded entity"", ""Physical entity"", ""Entity"", ""physical structure""]"	"[""Social_group"", ""social groups"", ""Social group"", ""Group"", ""Organization"", ""organization""]"	SOCIAL GROUPS ARE BUILDINGS
"[""Building"", ""buildings"", ""Physical structure"", ""Complex physical object"", ""Object"", ""objects"", ""complex structures"", ""Bounded entity"", ""Physical entity"", ""Entity""]"	"[""Theory"", ""theories"", ""Idea"", ""ideas"", ""Awareness""]"	THEORIES ARE BUILDINGS
"[""Building"", ""strong building"", ""Physical structure"", ""Complex physical object"", ""Object"", ""Bounded entity"", ""Physical entity"", ""Entity""]"	"[""Government institution"", ""effective government institution"", ""Institution"", ""Organization"", ""Social group"", ""Group""]"	EFFECTIVE GOVERNMENT INSTITUTION IS A STRONG BUILDING
"[""Bully"", ""bullies""]"	"[""Nation"", ""nations who abuse power"", ""Political region""]"	NATIONS WHO ABUSE POWER ARE BULLIES
"[""Bully"", ""physical bullies""]"	"[""State leadership"", ""abusive political leaders"", ""Leadership""]"	ABUSIVE POLITICAL LEADERS ARE PHYSICAL BULLIES
"[""Burden"", ""burden"", ""Motion-affecting objects"", ""Motion-affecting external factors"", ""Motion impediments"", ""Impediment to motion"", ""Affected motion"", ""Causation"", ""Complex_process""]"	"[""Regulation"", ""government regulation""]"	GOVERNMENT REGULATION IS A BURDEN
"[""Burden"", ""burden"", ""Motion-affecting objects"", ""Physical harm"", ""causing harm"", ""Motion-affecting external factors"", ""Motion impediments"", ""Impediment to motion"", ""Affected motion"", ""Causation"", ""Complex_process"", ""Harm""]"	"[""Taxation"", ""taxation"", ""Governing action"", ""responsibilities"", ""Difficulties in action"", ""difficulties in action"", ""Purposeful action"", ""Action"", ""Process""]"	TAXATION IS A BURDEN
"[""Burden"", ""burdens"", ""Motion-affecting objects"", ""Motion-affecting external factors"", ""Motion impediments"", ""Impediment to motion"", ""Affected motion"", ""Causation"", ""Complex_process""]"	"[""Disease"", ""diseases"", ""Physical affliction"", ""Harm to living entity"", ""Physical harm"", ""Harm"", ""Causation"", ""Complex_process""]"	DISEASES ARE BURDENS
"[""Burden"", ""physical burden"", ""Motion-affecting objects"", ""Motion impediments"", ""impediments to movement"", ""Motion-affecting external factors"", ""Impediment to motion"", ""Affected motion"", ""Causation"", ""Complex_process""]"	"[""Improving economic status"", ""impediments to improving economic status"", ""Change of state"", ""Improving a state"", ""Difficulties in action"", ""difficulties"", ""Experiencing_a_state"", ""Process""]"	IMPEDIMENTS TO IMPROVING ECONOMIC STATUS IS PHYSICAL BURDEN
"[""Burden"", ""physical burdens"", ""Motion-affecting objects"", ""Motion impediments"", ""impediments to movement"", ""Motion-affecting external factors"", ""Impediment to motion"", ""Affected motion"", ""Causation"", ""Complex_process""]"	"[""Difficulties in action"", ""difficulties in action""]"	DIFFICULTIES IN ACTION ARE PHYSICAL BURDENS
"[""Business"", ""business"", ""Businesses""]"	"[""Nation"", ""nation"", ""Political region""]"	NATION IS A BUSINESS
"[""Business"", ""business""]"	"[""Government institution"", ""government"", ""Institution"", ""institution"", ""Organization"", ""Social group"", ""Group""]"	GOVERNMENT IS A BUSINESS
"[""Business"", ""business""]"	"[""Institution"", ""institution"", ""Organization"", ""Social group"", ""Group""]"	INSTITUTION IS A BUSINESS
"[""Business"", ""employers""]"	"[""Nation"", ""citizens"", ""Political region""]"	CITIZENS ARE EMPLOYERS
"[""Business"", ""poorly-managed business""]"	"[""Government"", ""ineffective government"", ""Organization"", ""Social group"", ""Group""]"	INEFFECTIVE GOVERNMENT IS A POORLY-MANAGED BUSINESS
"[""Business"", ""well-managed business""]"	"[""Government institution"", ""effective government"", ""Institution"", ""Organization"", ""Social group"", ""Group""]"	EFFECTIVE GOVERNMENT IS A WELL-MANAGED BUSINESS
"[""Card game"", ""playing a game"", ""Game"", ""competition"", ""Recreational competition"", ""Competition""]"	"[""Gun rights"", ""considering the importance of rights"", ""Rights"", ""dealing with rights"", ""argument""]"	CONSIDERING THE IMPORTANCE OF RIGHTS IS PLAYING A GAME
"[""Cause contact"", ""causing contact"", ""Causation"", ""Complex_process""]"	"[""Relationship"", ""making related""]"	MAKING RELATED IS CAUSING CONTACT
"[""Cause to see"", ""showing"", ""Cause_to_perceive""]"	"[""Reasoning"", ""proving"", ""Cognizing""]"	PROVING IS SHOWING
"[""Cause to see"", ""showing""]"	"[""Communication"", ""communicating""]"	COMMUNICATING IS SHOWING
"[""Cause_to_perceive"", ""pointing"", ""Cause to see"", ""showing""]"	"[""Communication"", ""communicating""]"	COMMUNICATING IS POINTING
"[""Caused downward motion"", ""caused downward motion"", ""Forced motion"", ""caused change of location"", ""Affected motion"", ""Causation"", ""Complex_process""]"	"[""Poverty"", ""caused impoverishment"", ""Economic status"", ""Social problems"", ""Caused change of state"", ""caused change of state"", ""Social group"", ""Status"", ""Problem"", ""Causation"", ""Group"", ""Complex_process""]"	CAUSED IMPOVERISHMENT IS CAUSED DOWNWARD MOTION
"[""Caused upward motion"", ""cause upward motion"", ""Forced motion"", ""Affected motion"", ""Causation"", ""Complex_process""]"	"[""Quantity"", ""cause increase in quantity""]"	CAUSE INCREASE IN QUANTITY IS CAUSE UPWARD MOTION
"[""Caused upward motion"", ""caused upward motion"", ""Forced motion"", ""caused change of location"", ""Affected motion"", ""Causation"", ""Complex_process""]"	"[""Improving economic status"", ""caused improved economic status"", ""Change of state"", ""Improving a state"", ""Caused change of state"", ""caused change of state"", ""Experiencing_a_state"", ""Process"", ""Causation"", ""Complex_process""]"	CAUSED IMPROVED ECONOMIC STATUS IS CAUSED UPWARD MOTION
"[""Center periphery"", ""central""]"	"[""Importance"", ""important""]"	IMPORTANT IS CENTRAL
"[""Center periphery"", ""centrality""]"	"[""Power"", ""power""]"	POWER IS CENTRALITY
"[""Child care"", ""childcare provider"", ""Person"", ""person"", ""Animate entity"", ""Sentient entity"", ""Biological entity"", ""organism"", ""Entity"", ""Complex physical object"", ""Object"", ""Bounded entity"", ""Physical entity""]"	"[""Government"", ""government"", ""Organization"", ""Social group"", ""Group""]"	GOVERNMENT IS A CHILDCARE PROVIDER
"[""Citizens"", ""good citizens"", ""People_by_jurisdiction""]"	"[""Nation"", ""cooperative nations"", ""Political region""]"	COOPERATIVE NATIONS ARE GOOD CITIZENS
"[""Cleanliness"", ""cleanliness""]"	"[""Purity"", ""purity""]"	PURITY IS CLEANLINESS
"[""Cleanliness"", ""cleansing""]"	"[""Purity"", ""purifying""]"	PURIFYING IS CLEANSING
"[""Clear paths to accessing a location"", ""aids to accessing locations along a path"", ""Access to a location"", ""locations along a path"", ""Location"", ""locations"", ""Access""]"	"[""Educational opportunities"", ""aids to using educational opportunities"", ""Opportunities"", ""educational opportunities"", ""opportunities""]"	AIDS TO USING EDUCATIONAL OPPORTUNITIES ARE AIDS TO ACCESSING LOCATIONS ALONG A PATH
"[""Closing a portal"", ""closing a portal"", ""Portals"", ""Motion impediments"", ""impediments to movement"", ""Impediment to motion"", ""Affected motion"", ""Causation"", ""Complex_process""]"	"[""Educational opportunities"", ""preventing utilization of educational resources"", ""Opportunities"", ""Difficulties in action"", ""difficulties""]"	PREVENTING UTILIZATION OF EDUCATIONAL RESOURCES IS CLOSING A PORTAL
"[""Cognizing"", ""bodily functioning""]"	"[""Bodily_functioning"", ""cognizing""]"	COGNIZING IS BODILY FUNCTIONING
"[""Commodity"", ""commodity"", ""Resource"", ""resource"", ""entity""]"	"[""Time"", ""time""]"	TIME IS A COMMODITY
"[""Commodity"", ""commodity""]"	"[""Democratic ideology"", ""democratic ideology"", ""Ideology""]"	DEMOCRATIC IDEOLOGY IS A COMMODITY
"[""Competition"", ""winning a competition""]"	"[""Cancer"", ""surviving cancer"", ""Disease"", ""Physical affliction"", ""Harm to living entity"", ""Physical harm"", ""Harm"", ""Causation"", ""Complex_process""]"	SURVIVING CANCER IS WINNING A COMPETITION
"[""Competitive sport"", ""competitive sports events"", ""Recreational competition"", ""Game"", ""game"", ""Competition""]"	"[""Election"", ""elections"", ""Political competition"", ""Competition""]"	ELECTIONS ARE COMPETITIVE SPORTS EVENTS
"[""Competitive sport"", ""competitive sports"", ""Recreational competition"", ""Competition""]"	"[""Economic competition"", ""business competition"", ""Competition""]"	BUSINESS COMPETITION IS COMPETITIVE SPORTS
"[""Complex physical object"", ""complex physical object"", ""Object"", ""Bounded entity"", ""Physical entity"", ""Entity""]"	"[""Institution"", ""institution"", ""Organization"", ""Social group"", ""social groups"", ""Group"", ""organization""]"	INSTITUTION IS A COMPLEX PHYSICAL OBJECT
"[""Complex physical object"", ""complex physical systems"", ""Object"", ""Bounded entity"", ""Physical entity"", ""Entity""]"	"[""Group of related ideas"", ""idea systems"", ""Category""]"	IDEA SYSTEMS ARE COMPLEX PHYSICAL SYSTEMS
"[""Complex physical object"", ""complex structure"", ""Object"", ""Bounded entity"", ""Physical entity"", ""Entity""]"	"[""Nation"", ""nation"", ""Political region""]"	NATION IS A COMPLEX STRUCTURE
"[""Complex physical object"", ""complex structure"", ""Object"", ""Physical structure"", ""physical structure"", ""Bounded entity"", ""Physical entity"", ""Entity""]"	"[""Career"", ""career"", ""Organization"", ""organization"", ""Social group"", ""Group""]"	CAREER IS A COMPLEX STRUCTURE
"[""Complex physical object"", ""complex structure"", ""Object"", ""Physical structure"", ""physical structure"", ""Bounded entity"", ""Physical entity"", ""Entity""]"	"[""Company"", ""company"", ""Organization"", ""organization"", ""Social group"", ""Group""]"	COMPANY IS A COMPLEX STRUCTURE
"[""Complex physical object"", ""complex structure"", ""Object"", ""Physical structure"", ""physical structure"", ""Bounded entity"", ""Physical entity"", ""Entity""]"	"[""Economy"", ""economy"", ""Organization"", ""organization"", ""Social group"", ""Group""]"	ECONOMY IS A COMPLEX STRUCTURE
"[""Complex physical object"", ""complex structure"", ""Object"", ""Physical structure"", ""physical structure"", ""Bounded entity"", ""Physical entity"", ""Entity""]"	"[""Society"", ""society"", ""Organization"", ""organization"", ""Social group"", ""Group""]"	SOCIETY IS A COMPLEX STRUCTURE
"[""Complex physical object"", ""complex structures"", ""Object"", ""Bounded entity"", ""Physical entity"", ""Entity""]"	"[""Theory"", ""theories"", ""Logical structure"", ""logical structures""]"	THEORIES ARE COMPLEX STRUCTURES
"[""Complex physical object"", ""complex structures"", ""Object"", ""objects"", ""Bounded entity"", ""Physical entity"", ""Entity""]"	"[""Relationship"", ""relationships"", ""Organization"", ""organization"", ""Social group"", ""Group""]"	RELATIONSHIPS ARE COMPLEX STRUCTURES
"[""Complex physical object"", ""complex structures"", ""Object"", ""Physical structure"", ""physical structure"", ""Bounded entity"", ""Physical entity"", ""Entity""]"	"[""Social group"", ""social groups"", ""Group"", ""Organization"", ""organization""]"	SOCIAL GROUPS ARE COMPLEX STRUCTURES
"[""Complex physical object"", ""erect complex structures"", ""Object"", ""Bounded entity"", ""Physical entity"", ""Entity""]"	"[""Logical structure"", ""logical structures""]"	LOGICAL STRUCTURES ARE ERECT COMPLEX STRUCTURES
"[""Component of building"", ""component of building"", ""Architectural_part"", ""Object"", ""object"", ""Bounded entity"", ""Physical entity"", ""Entity""]"	"[""Education"", ""education""]"	EDUCATION IS COMPONENT OF BUILDING
"[""Computer"", ""computer"", ""Machine"", ""machine"", ""Physical structure"", ""Complex physical object"", ""Object"", ""Bounded entity"", ""Physical entity"", ""Entity""]"	"[""Mind"", ""mind""]"	MIND IS A COMPUTER
"[""Condition of physical object"", ""physical integrity""]"	"[""Nation"", ""national political functionality"", ""Political region""]"	NATIONAL POLITICAL FUNCTIONALITY IS PHYSICAL INTEGRITY
"[""Confinement"", ""environmental confinement"", ""Motion-affecting properties of the landscape"", ""Motion impediments"", ""impediments to movement"", ""Motion-affecting external factors"", ""Impediment to motion"", ""Affected motion"", ""Causation"", ""Complex_process""]"	"[""Improving economic status"", ""impediments to improving economic status"", ""Change of state"", ""Improving a state"", ""Difficulties in action"", ""difficulties"", ""Experiencing_a_state"", ""Process""]"	IMPEDIMENTS TO IMPROVING ECONOMIC STATUS IS ENVIRONMENTAL CONFINEMENT
"[""Confinement"", ""physical constraint"", ""Motion-affecting properties of the landscape"", ""Motion-affecting external factors"", ""Motion impediments"", ""Impediment to motion"", ""Affected motion"", ""Causation"", ""Complex_process""]"	"[""Regulation"", ""government regulation""]"	GOVERNMENT REGULATION IS A PHYSICAL CONSTRAINT
"[""Constructed Confinement"", ""constructed confinement"", ""Confinement"", ""Physical structure"", ""Motion impediments"", ""impediments to movement"", ""Motion-affecting properties of the landscape"", ""Complex physical object"", ""Object"", ""Bounded entity"", ""Physical entity"", ""Entity"", ""Impediment to motion"", ""Motion-affecting external factors"", ""Affected motion"", ""Causation"", ""Complex_process""]"	"[""Improving economic status"", ""impediments to improving economic status"", ""Change of state"", ""Improving a state"", ""Difficulties in action"", ""difficulties"", ""Experiencing_a_state"", ""Process""]"	IMPEDIMENTS TO IMPROVING ECONOMIC STATUS IS CONSTRUCTED CONFINEMENT
"[""Constructed Restraints"", ""constructed restraints"", ""Restraints"", ""Motion impediments"", ""impediments to movement"", ""Motion-affecting objects"", ""Motion-affecting external factors"", ""Impediment to motion"", ""Affected motion"", ""Causation"", ""Complex_process""]"	"[""Improving economic status"", ""impediments to improving economic status"", ""Change of state"", ""Improving a state"", ""Difficulties in action"", ""difficulties"", ""Experiencing_a_state"", ""Process""]"	IMPEDIMENTS TO IMPROVING ECONOMIC STATUS IS CONSTRUCTED RESTRAINTS
"[""Constructed Restraints"", ""physical restraint"", ""Restraints"", ""Motion-affecting objects"", ""Motion-affecting external factors"", ""Motion impediments"", ""Impediment to motion"", ""Affected motion"", ""Causation"", ""Complex_process""]"	"[""Gun control"", ""gun control"", ""Control"", ""control"", ""Law"", ""laws"", ""Complex process""]"	GUN CONTROL IS PHYSICAL RESTRAINT
"[""Containing"", ""containers"", ""Object"", ""objects"", ""Bounded entity"", ""Physical entity"", ""Entity""]"	"[""Relationship"", ""relationships""]"	RELATIONSHIPS ARE CONTAINERS
"[""Containing"", ""containers""]"	"[""Group"", ""groups""]"	GROUPS ARE CONTAINERS
"[""Containing"", ""containers""]"	"[""Part whole"", ""wholes""]"	WHOLES ARE CONTAINERS
"[""Containing"", ""containers""]"	"[""Word"", ""words"", ""Linguistic_meaning""]"	WORDS ARE CONTAINERS
"[""Containment"", ""container""]"	"[""Mind"", ""mind""]"	MIND IS A CONTAINER
"[""Containment"", ""container""]"	"[""Visual_field"", ""visual field""]"	VISUAL FIELD IS A CONTAINER
"[""Containment"", ""containers"", ""Bounded region"", ""bounded region"", ""Region""]"	"[""Social_group"", ""social groups""]"	SOCIAL GROUPS ARE CONTAINERS
"[""Containment"", ""containers""]"	"[""Political party"", ""political parties"", ""Group"", ""groups"", ""Aggregate""]"	POLITICAL PARTIES ARE CONTAINERS
"[""Containment"", ""containers""]"	"[""Time"", ""time periods"", ""Timespan"", ""Measure_duration""]"	TIME PERIODS ARE CONTAINERS
"[""Containment"", ""internal""]"	"[""Essence"", ""essential""]"	ESSENTIAL IS INTERNAL
"[""Contents"", ""contents""]"	"[""Constituents"", ""constituents""]"	CONSTITUENTS ARE CONTENTS
"[""Contents"", ""contents""]"	"[""Information"", ""information""]"	INFORMATION IS CONTENTS
"[""Crafting"", ""shaping"", ""Purposeful action"", ""Action"", ""Process""]"	"[""Forming words"", ""forming words""]"	FORMING WORDS IS SHAPING
"[""Create object"", ""creating objects"", ""Complex process"", ""Physical entity"", ""physical entities"", ""Entity""]"	"[""Economic resource"", ""augmenting economic assets"", ""Resource"", ""economic resources""]"	AUGMENTING ECONOMIC ASSETS IS CREATING OBJECTS
"[""Create object"", ""making objects"", ""Intentionally_create"", ""Complex process""]"	"[""Legislative action"", ""legislative activity"", ""Governing action"", ""Purposeful action"", ""Action"", ""Process""]"	LEGISLATIVE ACTIVITY IS MAKING OBJECTS
"[""Create object"", ""object creation"", ""Complex process""]"	"[""Cause to begin existence"", ""causing to exist""]"	CAUSING TO EXIST IS OBJECT CREATION
"[""Crime"", ""crime""]"	"[""Poverty"", ""poverty"", ""Economic status"", ""Social problems"", ""Social group"", ""Status"", ""Problem"", ""Group""]"	POVERTY IS A CRIME
"[""Cultivation"", ""cultivation""]"	"[""developing an attribute""]"	DEVELOPING AN ATTRIBUTE IS CULTIVATION
"[""Darkness"", ""dark""]"	"[""Evil"", ""evil""]"	EVIL IS DARK
"[""Decay"", ""decay"", ""Destructive natural process"", ""Destructive_natural_process"", ""destructive natural process"", ""Natural process"", ""Destroying"", ""Process"", ""Physical harm"", ""Harm"", ""Causation"", ""Complex_process"", ""Destructive force"", ""destructive force"", ""Force"", ""forces""]"	"[""Corruption"", ""corruption""]"	CORRUPTION IS DECAY
"[""Decision making"", ""townhall decision-making""]"	"[""Democracy"", ""democratic decision-making""]"	DEMOCRATIC DECISION-MAKING IS TOWNHALL DECISION-MAKING
"[""Degeneration"", ""degeneration""]"	"[""Immorality"", ""immorality""]"	IMMORALITY IS DEGENERATION
"[""Destructive force"", ""destructive force"", ""Force"", ""forces""]"	"[""Moral corruption"", ""moral corruption"", ""Corruption""]"	MORAL CORRUPTION IS A DESTRUCTIVE FORCE
"[""Destructive natural process"", ""occurence of sudden destructive natural force"", ""Natural process"", ""Destroying"", ""Force"", ""force"", ""Process"", ""Physical harm"", ""Harm"", ""Causation"", ""Complex_process""]"	"[""Taxation"", ""increase in taxation"", ""Governing action"", ""taxation"", ""Purposeful action"", ""Action"", ""Process""]"	INCREASE IN TAXATION IS OCCURENCE OF SUDDEN DESTRUCTIVE NATURAL FORCE
"[""Destructive_natural_process"", ""destructive natural process"", ""Destructive force"", ""destructive force"", ""Force"", ""forces""]"	"[""Corruption"", ""corruption"", ""Moral corruption"", ""moral corruption""]"	CORRUPTION IS A DESTRUCTIVE NATURAL PROCESS
"[""Diagnosis of affliction"", ""diagnosis of affliction""]"	"[""Social problems"", ""analysis of social problems"", ""Problem""]"	ANALYSIS OF SOCIAL PROBLEMS IS DIAGNOSIS OF AFFLICTION
"[""Differences in distance"", ""distance along a path""]"	"[""Degree"", ""degree""]"	DEGREE IS DISTANCE ALONG A PATH
"[""Digestion"", ""digesting"", ""Cognizing"", ""bodily functioning""]"	"[""Understanding"", ""understanding"", ""Knowing"", ""Bodily_functioning"", ""cognizing"", ""Cognizing""]"	UNDERSTANDING IS DIGESTING
"[""Directed vision"", ""being positioned to see well""]"	"[""Knowing"", ""being poised to know"", ""Cognizing""]"	BEING POISED TO KNOW IS BEING POSITIONED TO SEE WELL
"[""Disease spread"", ""extent of affliction""]"	"[""Social problems"", ""extent of social problems"", ""Problem""]"	EXTENT OF SOCIAL PROBLEMS IS EXTENT OF AFFLICTION
"[""Disease treatment"", ""treating disease"", ""Treating a physical affliction"", ""Health treatment""]"	"[""Crime"", ""causing decrease in crime"", ""Addressing social problems"", ""addressing social problems"", ""Causation"", ""Complex_process""]"	CAUSING DECREASE IN CRIME IS TREATING DISEASE
"[""Disease"", ""disease effect"", ""Physical affliction"", ""Harm to living entity"", ""Physical harm"", ""Harm"", ""Causation"", ""Complex_process""]"	"[""Corruption"", ""corruption effect""]"	CORRUPTION EFFECT IS DISEASE EFFECT
"[""Disease"", ""disease"", ""Physical affliction"", ""Destructive_natural_process"", ""destructive natural process"", ""Harm to living entity"", ""Physical harm"", ""Harm"", ""Causation"", ""Complex_process"", ""Destructive force"", ""destructive force"", ""Force"", ""forces""]"	"[""Corruption"", ""corruption"", ""Social problems"", ""social problems"", ""Problem""]"	CORRUPTION IS A DISEASE
"[""Disease"", ""disease"", ""Physical affliction"", ""Harm to living entity"", ""Physical harm"", ""Harm"", ""Causation"", ""Complex_process""]"	"[""Crime"", ""crime"", ""Social problems"", ""social problems"", ""Problem""]"	CRIME IS A DISEASE
"[""Disease"", ""disease"", ""Physical affliction"", ""Harm to living entity"", ""Physical harm"", ""Harm"", ""Causation"", ""Complex_process""]"	"[""Gun control"", ""gun control regulation"", ""Control"", ""Complex process""]"	GUN CONTROL REGULATION IS A DISEASE
"[""Disease"", ""disease"", ""Physical affliction"", ""Harm to living entity"", ""Physical harm"", ""Harm"", ""Causation"", ""Complex_process""]"	"[""Morality"", ""immorality""]"	IMMORALITY IS DISEASE
"[""Disease"", ""disease"", ""Physical affliction"", ""Harm to living entity"", ""Physical harm"", ""Harm"", ""Causation"", ""Complex_process""]"	"[""Personal weapon"", ""guns"", ""Complex physical object"", ""Object"", ""Bounded entity"", ""Physical entity"", ""Entity""]"	GUNS ARE A DISEASE
"[""Disease"", ""disease"", ""Physical affliction"", ""Harm to living entity"", ""Physical harm"", ""Harm"", ""Causation"", ""Complex_process""]"	"[""Regulation"", ""regulation""]"	REGULATION IS A DISEASE
"[""Disease"", ""disease"", ""Physical affliction"", ""Physical harm"", ""physical harm"", ""Harm to living entity"", ""Harm"", ""Causation"", ""Complex_process""]"	"[""Poverty"", ""poverty"", ""Economic status"", ""Social problems"", ""social problems"", ""Social group"", ""Status"", ""Problem"", ""Group""]"	POVERTY IS A DISEASE
"[""Disease"", ""diseases"", ""Medical_conditions"", ""Physical affliction"", ""Harm to living entity"", ""Physical harm"", ""Harm"", ""Causation"", ""Complex_process""]"	"[""Taxation"", ""taxes"", ""Governing action"", ""Social problems"", ""social problems"", ""Purposeful action"", ""Problem"", ""Action"", ""Process""]"	TAXES ARE DISEASES
"[""Disease"", ""diseases"", ""Physical affliction"", ""physical afflictions"", ""Harm to living entity"", ""Physical harm"", ""Harm"", ""Causation"", ""Complex_process""]"	"[""Social problems"", ""social problems"", ""Problem""]"	SOCIAL PROBLEMS ARE DISEASES
"[""Disease"", ""spread of disease"", ""Physical affliction"", ""Harm to living entity"", ""Physical harm"", ""Harm"", ""Causation"", ""Complex_process""]"	"[""Crime"", ""increase in crime""]"	INCREASE IN CRIME IS SPREAD OF DISEASE
"[""Disgusting"", ""disgusting foods"", ""Impurity""]"	"[""Idea"", ""disturbing ideas"", ""cognitive aversion""]"	DISTURBING IDEAS ARE DISGUSTING FOODS
"[""Disgusting"", ""disgusting"", ""Impurity"", ""impurity""]"	"[""Wealth"", ""excess wealth"", ""Economic status"", ""Immorality"", ""immorality"", ""Social group"", ""Status"", ""Group""]"	EXCESS WEALTH IS DISGUSTING
"[""Disgusting"", ""physical disgust"", ""Impurity""]"	"[""Idea"", ""cognitive aversion""]"	COGNITIVE AVERSION IS PHYSICAL DISGUST
"[""Disgusting"", ""stinky"", ""Impurity""]"	"[""Badness"", ""bad""]"	BAD IS STINKY
"[""Dissect"", ""dissecting"", ""Cause_to_fragment"", ""Cut"", ""Force-application"", ""Physical harm"", ""Action"", ""Force-Dynamic Interaction"", ""Process"", ""Complex process"", ""Harm"", ""Causation"", ""Complex_process""]"	"[""Analysis"", ""analyzing"", ""Scrutiny"", ""Reasoning"", ""Cognizing""]"	ANALYZING IS DISSECTING
"[""Dividing"", ""dividing""]"	"[""Distinguishing"", ""distinguishing""]"	DISTINGUISHING IS DIVIDING
"[""Downward motion"", ""downward motion"", ""Motion along a path"", ""Motion"", ""Process""]"	"[""Emotion"", ""worsening mood"", ""Experiencer_obj"", ""Experiencing a state""]"	WORSENING MOOD IS DOWNWARD MOTION
"[""Downward motion"", ""downward motion"", ""Motion along a path"", ""Motion"", ""Process""]"	"[""Quantity"", ""decrease in quantity""]"	DECREASE IN QUANTITY IS DOWNWARD MOTION
"[""Downward motion"", ""falling"", ""Motion along a path"", ""Motion"", ""Process""]"	"[""Evil"", ""doing evil""]"	DOING EVIL IS FALLING
"[""Downward motion"", ""moving downwards"", ""Motion along a path"", ""change of location"", ""Motion"", ""Process"", ""Being at a location"", ""being at a location"", ""Spatial relation"", ""spatial relation with an entity"", ""Trajector landmark"", ""Figure ground""]"	"[""Impoverished"", ""becoming impoverished"", ""Experiencing a negative state"", ""Experiencing an economic status"", ""Change of state"", ""change of state"", ""Experiencing a state"", ""Experiencing_a_state"", ""Process"", ""experiencing a state""]"	BECOMING IMPOVERISHED IS MOVING DOWNWARDS
"[""Draw_a_picture"", ""drawing a picture"", ""Cause to see"", ""showing""]"	"[""Communication"", ""communicating""]"	COMMUNICATING IS DRAWING A PICTURE
"[""Eating"", ""eating"", ""Ingestion"", ""Consume"", ""Bodily functioning""]"	"[""Resource consumption"", ""consuming resources""]"	CONSUMING RESOURCES IS EATING
"[""Eating"", ""eating"", ""Ingestion"", ""Consume"", ""Cognizing"", ""bodily functioning"", ""Bodily functioning""]"	"[""Cognizing"", ""cognizing"", ""Bodily_functioning""]"	COGNIZING IS EATING
"[""Eating"", ""eating"", ""Ingestion"", ""Consume"", ""Cognizing"", ""bodily functioning"", ""Bodily functioning""]"	"[""Thinking about"", ""acquiring ideas"", ""Bodily_functioning"", ""cognizing""]"	ACQUIRING IDEAS IS EATING
"[""Eating"", ""swallowing"", ""Ingestion"", ""Consume"", ""Bodily functioning""]"	"[""Considering"", ""accepting""]"	ACCEPTING IS SWALLOWING
"[""Enable ability to access locations"", ""enable ability to access locations"", ""Increase ease of motion"", ""increase ease of motion""]"	"[""Financial resource"", ""enable ability to utilize resources"", ""Resource"", ""Increase ease of action"", ""increase ease of action""]"	ENABLE ABILITY TO UTILIZE RESOURCES IS ENABLE ABILITY TO ACCESS LOCATIONS
"[""Entity"", ""entities""]"	"[""Attribute"", ""attributes""]"	ATTRIBUTES ARE ENTITIES
"[""Entrapment"", ""trap""]"	"[""Welfare"", ""government assistance""]"	GOVERNMENT ASSISTANCE IS A TRAP
"[""Environmental restraints"", ""environmental restraints"", ""Restraints"", ""Motion impediments"", ""impediments to movement"", ""Motion-affecting objects"", ""Motion-affecting external factors"", ""Impediment to motion"", ""Affected motion"", ""Causation"", ""Complex_process""]"	"[""Improving economic status"", ""impediments to improving economic status"", ""Change of state"", ""Improving a state"", ""Difficulties in action"", ""difficulties"", ""Experiencing_a_state"", ""Process""]"	IMPEDIMENTS TO IMPROVING ECONOMIC STATUS IS ENVIRONMENTAL RESTRAINTS
"[""Equalizing quantities"", ""equalizing quantities""]"	"[""Educational opportunities"", ""making educational opportunity the same for everyone"", ""Opportunities""]"	MAKING EDUCATIONAL OPPORTUNITY THE SAME FOR EVERYONE IS EQUALIZING QUANTITIES
"[""Erosion"", ""erosion"", ""Destructive natural process"", ""Destructive_natural_process"", ""destructive natural process"", ""Natural process"", ""Destroying"", ""Destructive force"", ""destructive force"", ""Process"", ""Physical harm"", ""Force"", ""forces"", ""Harm"", ""Causation"", ""Complex_process""]"	"[""Corruption"", ""corruption""]"	CORRUPTION IS EROSION
"[""Excess body weight"", ""bloated body"", ""Body weight"", ""Weight""]"	"[""Government"", ""inefficient government"", ""Leadership"", ""Organization"", ""Social group"", ""Group""]"	INEFFICIENT GOVERNMENT IS A BLOATED BODY
"[""Excess body weight"", ""excess body weight"", ""Body weight"", ""body weight"", ""Weight""]"	"[""Financial resource"", ""excess wealth"", ""Resource"", ""amount of resource""]"	EXCESS WEALTH IS EXCESS BODY WEIGHT
"[""Factory"", ""factory workers""]"	"[""Bureaucracy"", ""bureaucrats""]"	BUREAUCRATS ARE FACTORY WORKERS
"[""Factory"", ""factory""]"	"[""Institution"", ""institution"", ""Organization"", ""Social group"", ""Group""]"	INSTITUTION IS A FACTORY
"[""Family"", ""child"", ""Social group"", ""Group""]"	"[""Country"", ""country""]"	COUNTRY IS A CHILD
"[""Family"", ""family"", ""Kinship"", ""Social group"", ""Group""]"	"[""Social group"", ""social group"", ""Group""]"	SOCIAL GROUP IS A FAMILY
"[""Family"", ""family"", ""Social group"", ""Complex physical object"", ""complex structures"", ""Group"", ""Object"", ""Physical structure"", ""physical structure"", ""Bounded entity"", ""Physical entity"", ""Entity""]"	"[""Community"", ""community"", ""Social group"", ""social groups"", ""social group"", ""Group"", ""Organization"", ""organization""]"	COMMUNITY IS A FAMILY
"[""Family"", ""family"", ""Social group"", ""Group""]"	"[""Company"", ""company"", ""Organization"", ""Community"", ""community"", ""Aggregate"", ""Social group"", ""Group"", ""social groups"", ""social group"", ""organization""]"	COMPANY IS A FAMILY
"[""Family"", ""family"", ""Social group"", ""Group""]"	"[""Market"", ""market"", ""Institution"", ""Organization"", ""Social group"", ""Group""]"	MARKET IS A FAMILY
"[""Family"", ""family"", ""Social group"", ""Group""]"	"[""Nation"", ""nation"", ""Political region""]"	NATION IS A FAMILY
"[""Feeding"", ""feeding""]"	"[""Communication"", ""communicating""]"	COMMUNICATING IS FEEDING
"[""Fierce animal"", ""animal"", ""Animal"", ""Animate entity"", ""Destructive force"", ""destructive force"", ""animate entities"", ""Biological entity"", ""Force"", ""forces"", ""Complex physical object"", ""Object"", ""Bounded entity"", ""Physical entity"", ""Entity""]"	"[""Crime"", ""crime"", ""Moral corruption"", ""moral corruption"", ""Social problems"", ""social problems"", ""Corruption"", ""Problem""]"	CRIME IS AN ANIMAL
"[""Fierce animal"", ""fierce creature"", ""Animal"", ""Animate entity"", ""animate entities"", ""Biological entity"", ""Complex physical object"", ""Object"", ""Bounded entity"", ""Physical entity"", ""Entity""]"	"[""Poverty"", ""poverty"", ""Economic status"", ""Social problems"", ""social problems"", ""Social group"", ""Status"", ""Problem"", ""Group""]"	POVERTY IS A FIERCE CREATURE
"[""Fierce animal"", ""octopus"", ""Animal"", ""Animate entity"", ""Biological entity"", ""Complex physical object"", ""Object"", ""Bounded entity"", ""Physical entity"", ""Entity""]"	"[""Bureaucracy"", ""bureacracy""]"	BUREACRACY IS AN OCTOPUS
"[""Financial_transaction"", ""financial transaction""]"	"[""Moral_action"", ""moral action""]"	MORAL ACTION IS A FINANCIAL TRANSACTION
"[""Fire"", ""fire"", ""Heat"", ""heat"", ""temperature""]"	"[""Anger"", ""anger"", ""Emotion"", ""Experiencing a state""]"	ANGER IS FIRE
"[""Firmness"", ""firm"", ""Condition of physical object""]"	"[""Certainty"", ""certain""]"	CERTAIN IS FIRM
"[""Fixing"", ""fixing a broken object"", ""Restore""]"	"[""Solving a problem"", ""solving a problem""]"	SOLVING A PROBLEM IS FIXING A BROKEN OBJECT
"[""Fluid motion"", ""fluid motion"", ""Motion"", ""Process""]"	"[""Money"", ""money transfer"", ""Financial resource"", ""Resource""]"	MONEY TRANSFER IS FLUID MOTION
"[""Fluid motion"", ""fluid"", ""Fluidic_motion"", ""Motion"", ""Mass"", ""mass"", ""Process""]"	"[""Personal weapon"", ""amount of guns"", ""Weapon"", ""Complex physical object"", ""Multiplex"", ""multiplicity"", ""Object"", ""Bounded entity"", ""Physical entity"", ""Entity""]"	AMOUNT OF GUNS IS A FLUID
"[""Fluid motion"", ""fluid"", ""Motion"", ""Process""]"	"[""Injurious gun use"", ""amount of gun violence"", ""Social problems"", ""Harm to living entity"", ""Problem"", ""Physical harm"", ""Harm"", ""Causation"", ""Complex_process""]"	AMOUNT OF GUN VIOLENCE IS A FLUID
"[""Fluid motion"", ""fluid"", ""Motion"", ""Process""]"	"[""Injurious gun use"", ""gun violence"", ""Social problems"", ""Harm to living entity"", ""Violence"", ""violence"", ""Problem"", ""Physical harm"", ""Harm"", ""Causation"", ""Complex_process""]"	GUN VIOLENCE IS A FLUID
"[""Fluid motion"", ""fluid"", ""Motion"", ""Process""]"	"[""Violence"", ""violence""]"	VIOLENCE IS A FLUID
"[""Fluid_containment"", ""container for emotions""]"	"[""Emotion"", ""body"", ""Experiencing a state""]"	BODY IS A CONTAINER FOR EMOTIONS
"[""Food"", ""appetite for food"", ""Physical entity"", ""Eating"", ""eating"", ""Entity"", ""Ingestion"", ""Consume"", ""Cognizing"", ""bodily functioning"", ""Bodily functioning""]"	"[""Idea"", ""interest in ideas"", ""Cognizing"", ""cognizing"", ""Bodily_functioning""]"	INTEREST IN IDEAS IS APPETITE FOR FOOD
"[""Food"", ""appetizing foods"", ""Physical entity"", ""Entity""]"	"[""Idea"", ""interesting ideas""]"	INTERESTING IDEAS ARE APPETIZING FOODS
"[""Food"", ""food"", ""Physical entity"", ""Entity""]"	"[""Idea"", ""ideas""]"	IDEAS ARE FOOD
"[""Food"", ""nourishing"", ""Physical entity"", ""Entity""]"	"[""Causation"", ""ongoing causation"", ""Complex_process""]"	Ongoing causation is nourishing
"[""Food_preparation"", ""food preparation""]"	"[""Cognizing"", ""preparing ideas to be understood""]"	PREPARING IDEAS TO BE UNDERSTOOD IS FOOD PREPARATION
"[""Force"", ""compelling force""]"	"[""Compulsion"", ""compulsion""]"	COMPULSION IS A COMPELLING FORCE
"[""Force"", ""force""]"	"[""Emotion"", ""emotion"", ""Experiencing a state""]"	EMOTION IS A FORCE
"[""Force"", ""force""]"	"[""Taxation"", ""taxation"", ""Governing action"", ""Purposeful action"", ""Action"", ""Process""]"	TAXATION IS A FORCE
"[""Force"", ""forces""]"	"[""Causation"", ""causes"", ""Complex_process""]"	CAUSES ARE FORCES
"[""Forced motion"", ""caused change of location"", ""Affected motion"", ""Causation"", ""Complex_process""]"	"[""Caused change of state"", ""caused change of state"", ""Causation"", ""Complex_process""]"	CAUSED CHANGE OF STATE IS CAUSED CHANGE OF LOCATION
"[""Forced motion"", ""causing motion along a path"", ""Affected motion"", ""Causation"", ""Complex_process""]"	"[""Legislation enactment"", ""enacting legislation"", ""Legislative action"", ""Government decision making"", ""Caused change of state"", ""caused change of state"", ""Cause_change"", ""Governing action"", ""Purposeful action"", ""Action"", ""Process"", ""Decision making"", ""Causation"", ""Complex_process""]"	ENACTING LEGISLATION IS CAUSING MOTION ALONG A PATH
"[""Forced motion"", ""force moving an object forward"", ""Cause_motion"", ""Affected motion"", ""Causation"", ""Complex_process""]"	"[""Leadership"", ""leading"", ""Cotheme"", ""causation""]"	LEADING IS A FORCE MOVING AN OBJECT FORWARD
"[""Forced motion"", ""forced movement"", ""Affected motion"", ""Causation"", ""Complex_process""]"	"[""Governing action"", ""inciting governing action"", ""Leadership"", ""Purposeful action"", ""Action"", ""Process""]"	INCITING GOVERNING ACTION IS FORCED MOVEMENT
"[""Forward motion"", ""moving through a terrain"", ""Motion along a path"", ""sequence of motions"", ""Journey"", ""journey"", ""Motion_along_a_path"", ""forward motion along a path"", ""moving along a path"", ""Motion"", ""Process"", ""Self propelled motion"", ""self-propelled motion along a path"", ""Self_motion"", ""Self propelled motion to a destination"", ""self-propelled motion to a destination"", ""Affected motion"", ""Motion to a location"", ""motion along a path"", ""Causation"", ""motion"", ""Complex_process""]"	"[""Life"", ""progressing through life"", ""life"", ""Action"", ""progress"", ""Process"", ""action"", ""Purposeful action"", ""purposeful action""]"	PROGRESSING THROUGH LIFE IS MOVING THROUGH A TERRAIN
"[""Friendships"", ""friendships""]"	"[""Alliances"", ""alliances""]"	ALLIANCES ARE FRIENDSHIPS
"[""Front"", ""ahead"", ""Figure ground"", ""Spatial relation""]"	"[""Time"", ""future""]"	FUTURE IS AHEAD
"[""Gain possession"", ""acquiring a desired object""]"	"[""Purposeful action"", ""achieving a purpose"", ""Action"", ""Process""]"	ACHIEVING A PURPOSE IS ACQUIRING A DESIRED OBJECT
"[""Gain possession"", ""acquiring"", ""Getting_scenario""]"	"[""Learning"", ""learning"", ""Cognizing""]"	LEARNING IS ACQUIRING
"[""Gain possession"", ""acquisition""]"	"[""Change of state"", ""change"", ""Experiencing_a_state"", ""Process""]"	CHANGE IS ACQUISITION
"[""Gain possession"", ""gaining a possession""]"	"[""Control"", ""attaining control"", ""Complex process""]"	ATTAINING CONTROL IS GAINING A POSSESSION
"[""Gain possession"", ""gaining a possession""]"	"[""Power"", ""gaining power"", ""Purposeful action"", ""achieving a purpose"", ""Action"", ""Process""]"	GAINING POWER IS GAINING A POSSESSION
"[""Gambling"", ""gambling"", ""Recreational competition"", ""Competition""]"	"[""Cancer treatment"", ""cancer treatment"", ""Disease treatment"", ""Treating a physical affliction"", ""Health treatment""]"	CANCER TREATMENT IS GAMBLING
"[""Gambling"", ""gambling"", ""Recreational competition"", ""Competition""]"	"[""Educational evaluation"", ""educational evaluation"", ""Evaluation""]"	EDUCATIONAL EVALUATION IS GAMBLING
"[""Game"", ""game"", ""Recreational competition"", ""Competition""]"	"[""Election"", ""election"", ""Political competition"", ""Competition""]"	ELECTION IS A GAME
"[""Game"", ""referee"", ""Recreational competition"", ""Competition""]"	"[""Government"", ""government"", ""Organization"", ""Social group"", ""Group""]"	GOVERNMENT IS REFEREE
"[""Geographic feature"", ""size of geographic feature"", ""Natural_features"", ""Object"", ""Size"", ""size"", ""Bounded entity"", ""Physical entity"", ""Entity""]"	"[""Poverty"", ""amount of poverty"", ""Economic status"", ""Social problems"", ""Social group"", ""Status"", ""Problem"", ""Group""]"	AMOUNT OF POVERTY IS SIZE OF GEOGRAPHIC FEATURE
"[""Government debt"", ""ocean""]"	"[""Ocean"", ""government debt""]"	GOVERNMENT DEBT IS OCEAN
"[""Grasp"", ""maintaining hold on physical position"", ""Object manipulation"", ""Motion-affecting actors"", ""Being at a location"", ""being at a location"", ""Motion-affecting external factors"", ""Force-application"", ""Motion impediments"", ""Impediment to motion"", ""Affected motion"", ""Causation"", ""Complex_process"", ""Action"", ""Force-Dynamic Interaction"", ""Process"", ""Complex process"", ""Trajector landmark"", ""Figure ground"", ""Spatial relation""]"	"[""Social status"", ""maintaining higher social status"", ""Status"", ""Experiencing an economic status"", ""experiencing an economic status"", ""Experiencing a state"", ""experiencing a state""]"	MAINTAINING HIGHER SOCIAL STATUS IS MAINTAINING HOLD ON PHYSICAL POSITION
"[""Group membership"", ""dues"", ""Membership""]"	"[""Taxation"", ""taxes"", ""Governing action"", ""Purposeful action"", ""Action"", ""Process""]"	TAXES ARE DUES
"[""Guided motion"", ""following"", ""Cotheme"", ""Affected motion"", ""Causation"", ""Complex_process""]"	"[""Understanding"", ""understanding"", ""Knowing"", ""Cognizing""]"	UNDERSTANDING IS FOLLOWING
"[""Guided motion"", ""guided motion along a path"", ""Affected motion"", ""Causation"", ""Complex_process""]"	"[""Action"", ""guided action"", ""Process""]"	GUIDED ACTION IS GUIDED MOTION ALONG A PATH
"[""Guided motion"", ""guiding"", ""Affected motion"", ""Causation"", ""Complex_process""]"	"[""Communication"", ""communicating""]"	COMMUNICATING IS GUIDING
"[""Hardness"", ""hardness""]"	"[""Difficulties in action"", ""difficulty""]"	DIFFICULTY IS HARDNESS
"[""Harm to living entity"", ""causing physical harm"", ""Cause_harm"", ""Physical harm"", ""Harm"", ""Causation"", ""Complex_process""]"	"[""Economic difficulty"", ""causing economic hardship"", ""Difficulty""]"	CAUSING ECONOMIC HARDSHIP IS CAUSING PHYSICAL HARM
"[""Harm"", ""harmful agents"", ""Causation"", ""Complex_process""]"	"[""Negatively evaluated condition"", ""negatively evaluated conditions"", ""State""]"	NEGATIVELY EVALUATED CONDITIONS ARE HARMFUL AGENTS
"[""Health treatment"", ""disease"", ""Treating a physical affliction"", ""treating an illness"", ""treating a physical affliction""]"	"[""Government institution"", ""government"", ""Institution"", ""Addressing social problems"", ""addressing social problems"", ""Social problems"", ""social problems"", ""Organization"", ""Social group"", ""Group"", ""Causation"", ""Problem"", ""Complex_process""]"	GOVERNMENT IS A DISEASE
"[""Health treatment"", ""doctor"", ""Treating a physical affliction"", ""treating an illness"", ""treating a physical affliction""]"	"[""Governing action"", ""government"", ""Purposeful action"", ""Addressing social problems"", ""addressing social problems"", ""Action"", ""Process"", ""Causation"", ""Complex_process""]"	GOVERNMENT IS A DOCTOR
"[""Health treatment"", ""patient"", ""Treating a physical affliction"", ""treating an illness"", ""Cure"", ""treating a physical affliction""]"	"[""Government institution"", ""government"", ""Institution"", ""Addressing social problems"", ""addressing social problems"", ""Organization"", ""Social group"", ""Group"", ""Causation"", ""Complex_process""]"	GOVERNMENT IS A PATIENT
"[""Heat"", ""heat"", ""temperature""]"	"[""Anger"", ""anger"", ""Emotion"", ""Emotional intensity"", ""emotional intensity"", ""Experiencing a state""]"	ANGER IS HEAT
"[""Heat"", ""heat"", ""temperature""]"	"[""Desire"", ""passion"", ""Emotional intensity"", ""emotional intensity"", ""Emotion"", ""Experiencing a state""]"	PASSION IS HEAT
"[""Heat"", ""heat""]"	"[""Activity"", ""intensity of activity""]"	INTENSITY OF ACTIVITY IS HEAT
"[""Heat"", ""hot"", ""temperature""]"	"[""Emotion"", ""emotionally intense"", ""Experiencing a state"", ""Emotional intensity"", ""emotional intensity""]"	EMOTIONALLY INTENSE IS HOT
"[""Heat"", ""temperature""]"	"[""Emotional intensity"", ""emotional intensity"", ""Emotion"", ""Experiencing a state""]"	EMOTIONAL INTENSITY IS TEMPERATURE
"[""Heat"", ""warmth"", ""Temperature""]"	"[""Sympathy"", ""sympathy""]"	SYMPATHY IS WARMTH
"[""Heat"", ""warmth""]"	"[""Affection"", ""affection"", ""Experiencer_focus"", ""Directed emotion"", ""Emotion"", ""Experiencing a state""]"	AFFECTION IS WARMTH
"[""Heating_fluid"", ""heat of fluid in a container"", ""Heat"", ""heat"", ""Pressure_in_a_container"", ""pressure in a container"", ""temperature"", ""Substance"", ""substances"", ""physical entity""]"	"[""Anger"", ""anger"", ""Emotion"", ""Experiencing a state""]"	ANGER IS THE HEAT OF FLUID IN A CONTAINER
"[""Hunger"", ""hunger""]"	"[""Desire"", ""desire""]"	DESIRE IS HUNGER
"[""Hunger"", ""hunger""]"	"[""Greed"", ""greed"", ""Desire"", ""desire""]"	GREED IS HUNGER
"[""Impediment to motion"", ""impeding motion"", ""Affected motion"", ""Causation"", ""Complex_process""]"	"[""Legislation enactment"", ""inhibitting enactment of legislation"", ""Legislative action"", ""Government decision making"", ""Difficulties in action"", ""difficulties"", ""inhibiting planned action"", ""Governing action"", ""Purposeful action"", ""Action"", ""Process"", ""Decision making""]"	INHIBITTING ENACTMENT OF LEGISLATION IS IMPEDING MOTION
"[""Impurity"", ""impurity""]"	"[""Immorality"", ""immorality""]"	IMMORALITY IS IMPURITY
"[""Inability to access a location"", ""inability to access a location"", ""Access to a location"", ""Location"", ""locations"", ""Access""]"	"[""Educational opportunities"", ""inability to utilize educational opportunity"", ""Opportunities"", ""opportunities""]"	INABILITY TO UTILIZE EDUCATIONAL OPPORTUNITY IS INABILITY TO ACCESS A LOCATION
"[""Increase ease of motion"", ""increase ease of motion""]"	"[""Increase ease of action"", ""increase ease of action""]"	INCREASE EASE OF ACTION IS INCREASE EASE OF MOTION
"[""Increase size"", ""physical growth""]"	"[""Morality"", ""moral growth""]"	MORAL GROWTH IS PHYSICAL GROWTH
"[""Insanity"", ""insanity"", ""Mental state""]"	"[""Advocacy"", ""fervent advocacy""]"	FERVENT ADVOCACY IS INSANITY
"[""Insanity"", ""insanity"", ""Mental state""]"	"[""Anger"", ""anger"", ""Emotion"", ""Experiencing a state""]"	ANGER IS INSANITY
"[""Insanity"", ""insanity"", ""Mental state""]"	"[""Gun control"", ""advocating gun control"", ""Control"", ""Advocacy"", ""fervent advocacy"", ""Complex process""]"	ADVOCATING GUN CONTROL IS INSANITY
"[""Insanity"", ""insanity"", ""Mental state""]"	"[""Gun ownership"", ""gun ownership""]"	GUN OWNERSHIP IS INSANITY
"[""Investment"", ""financial investment""]"	"[""Funding education"", ""improving education""]"	IMPROVING EDUCATION IS FINANCIAL INVESTMENT
"[""Investment"", ""investment"", ""resource transfer""]"	"[""Taxation"", ""taxation"", ""Governing action"", ""Purposeful action"", ""Action"", ""Process""]"	TAXATION IS INVESTMENT
"[""Journey"", ""journey"", ""Self propelled motion to a destination"", ""self-propelled motion to a destination"", ""Motion to a location""]"	"[""Cancer"", ""cancer"", ""Disease"", ""Purposeful action"", ""purposeful action"", ""Physical affliction"", ""Harm to living entity"", ""Physical harm"", ""Harm"", ""Causation"", ""Complex_process"", ""Action"", ""Process""]"	CANCER IS A JOURNEY
"[""Journey"", ""journey"", ""Self propelled motion"", ""self-propelled motion along a path"", ""Self propelled motion to a destination"", ""self-propelled motion to a destination"", ""Motion along a path"", ""sequence of motions"", ""Affected motion"", ""Motion to a location"", ""Motion"", ""Motion_along_a_path"", ""motion along a path"", ""motion"", ""Causation"", ""Process"", ""Complex_process""]"	"[""Life"", ""life"", ""Action"", ""action"", ""Purposeful action"", ""purposeful action"", ""Process""]"	LIFE IS A JOURNEY
"[""Journey"", ""journey""]"	"[""Romantic relationship"", ""romantic relationship""]"	ROMANTIC RELATIONSHIP IS A JOURNEY
"[""Journey"", ""journeys""]"	"[""Activity"", ""activities""]"	ACTIVITIES ARE JOURNEYS
"[""Journey"", ""vehicle encountering obstacles""]"	"[""Romantic relationship"", ""romantic relationship encountering difficulties""]"	ROMANTIC RELATIONSHIP ENCOUNTERING DIFFICULTIES IS A VEHICLE ENCOUNTERING OBSTACLES
"[""Lack of impediment to motion"", ""being free""]"	"[""Wealth"", ""being wealthy"", ""Economic status"", ""Freedom of action"", ""freedom of action"", ""Social group"", ""Status"", ""Group""]"	BEING WEALTHY IS BEING FREE
"[""Large geographic features"", ""large geographic features"", ""Geographic feature"", ""Size"", ""size"", ""Object"", ""Bounded entity"", ""Physical entity"", ""Entity""]"	"[""Financial resource"", ""excess wealth"", ""Resource"", ""Quantity"", ""quantity""]"	EXCESS WEALTH IS LARGE GEOGRAPHIC FEATURES
"[""Leadership"", ""leader"", ""Person"", ""person"", ""Animate entity"", ""Sentient entity"", ""Biological entity"", ""organism"", ""Entity"", ""Complex physical object"", ""Object"", ""Bounded entity"", ""Physical entity""]"	"[""Government"", ""government"", ""Organization"", ""Social group"", ""Group""]"	GOVERNMENT IS A LEADER
"[""Lightness"", ""light"", ""Level_of_light""]"	"[""Goodness"", ""goodness""]"	GOODNESS IS LIGHT
"[""Linguistic_activity"", ""linguistic activity""]"	"[""Cognizing"", ""thinking""]"	THINKING IS LINGUISTIC ACTIVITY
"[""Liquid"", ""fluid masses"", ""Substance"", ""physical entity""]"	"[""Group of related ideas"", ""idea systems"", ""Category""]"	IDEA SYSTEMS ARE FLUID MASSES
"[""Liquid"", ""liquid"", ""Substance"", ""physical entity""]"	"[""Resource"", ""resource""]"	RESOURCE IS A LIQUID
"[""Liquid"", ""liquid"", ""Substance"", ""substance"", ""physical entity""]"	"[""Money"", ""money"", ""Financial resource"", ""Resource"", ""resource""]"	MONEY IS A LIQUID
"[""Location"", ""locations""]"	"[""Opportunities"", ""opportunities""]"	OPPORTUNITIES ARE LOCATIONS
"[""Lose possession"", ""loss of a possession"", ""Lose_possession_scenario"", ""Losing"", ""Lose_possession""]"	"[""Control"", ""termination of control"", ""Complex process""]"	TERMINATION OF CONTROL IS LOSS OF A POSSESSION
"[""Lose possession"", ""loss""]"	"[""Change of state"", ""change"", ""Experiencing_a_state"", ""Process""]"	CHANGE IS LOSS
"[""Machine"", ""broken machine"", ""Physical structure"", ""Complex physical object"", ""Object"", ""Bounded entity"", ""Physical entity"", ""Entity""]"	"[""Bureaucracy"", ""nonfunctional bureaucracy""]"	NONFUNCTIONAL BUREAUCRACY IS A BROKEN MACHINE
"[""Machine"", ""broken machine"", ""Physical structure"", ""Complex physical object"", ""Object"", ""Bounded entity"", ""Physical entity"", ""Entity""]"	"[""Legislative branch"", ""nonfunctional legislature""]"	NONFUNCTIONAL LEGISLATURE IS A BROKEN MACHINE
"[""Machine"", ""machine parts"", ""Physical structure"", ""machine"", ""Complex physical object"", ""Object"", ""Bounded entity"", ""Physical entity"", ""Entity""]"	"[""Bureaucracy"", ""bureaucrats""]"	BUREAUCRATS ARE MACHINE PARTS
"[""Machine"", ""machine"", ""Physical structure"", ""Complex physical object"", ""complex physical object"", ""Object"", ""Bounded entity"", ""Physical entity"", ""Entity""]"	"[""Institution"", ""institution"", ""Organization"", ""Social group"", ""Group""]"	INSTITUTION IS A MACHINE
"[""Machine"", ""machine"", ""Physical structure"", ""Complex physical object"", ""complex structure"", ""Object"", ""Bounded entity"", ""Physical entity"", ""Entity"", ""physical structure""]"	"[""Economy"", ""economy""]"	ECONOMY IS A MACHINE
"[""Machine"", ""machine"", ""Physical structure"", ""Complex physical object"", ""complex structure"", ""Object"", ""Bounded entity"", ""Physical entity"", ""Entity""]"	"[""Nation"", ""nation"", ""Political region""]"	NATION IS A MACHINE
"[""Machine"", ""machine"", ""Physical structure"", ""Complex physical object"", ""Object"", ""Bounded entity"", ""Physical entity"", ""Entity""]"	"[""Bureaucracy"", ""bureaucracy""]"	BUREAUCRACY IS A MACHINE
"[""Machine"", ""machine"", ""Physical structure"", ""Complex physical object"", ""Object"", ""Bounded entity"", ""Physical entity"", ""Entity""]"	"[""Legislative branch"", ""legislature""]"	LEGISLATURE IS A MACHINE
"[""Machine"", ""machine"", ""Physical structure"", ""Complex physical object"", ""Object"", ""Bounded entity"", ""Physical entity"", ""Entity""]"	"[""Mind"", ""mind""]"	MIND IS A MACHINE
"[""Machine"", ""machine"", ""Physical structure"", ""Complex physical object"", ""Object"", ""Bounded entity"", ""Physical entity"", ""Entity""]"	"[""Organization"", ""organization"", ""Social group"", ""Group""]"	ORGANIZATION IS A MACHINE
"[""Machine"", ""machine"", ""Physical structure"", ""physical structure"", ""Complex physical object"", ""Object"", ""Bounded entity"", ""Physical entity"", ""Entity""]"	"[""Government institution"", ""government institution"", ""Institution"", ""institution"", ""Organization"", ""Social group"", ""Group""]"	GOVERNMENT INSTITUTION IS A MACHINE
"[""Machine"", ""smoothly functioning machine"", ""Gizmo"", ""Physical structure"", ""Complex physical object"", ""Object"", ""Bounded entity"", ""Physical entity"", ""Entity""]"	"[""Bureaucracy"", ""well-functioning bureaucracy""]"	WELL-FUNCTIONING BUREAUCRACY IS A SMOOTHLY FUNCTIONING MACHINE
"[""Machine"", ""well-functioning machine"", ""Physical structure"", ""Complex physical object"", ""Object"", ""Bounded entity"", ""Physical entity"", ""Entity""]"	"[""Government institution"", ""effective government institution"", ""Institution"", ""Organization"", ""Social group"", ""Group""]"	EFFECTIVE GOVERNMENT INSTITUTION IS A WELL-FUNCTIONING MACHINE
"[""Magic"", ""magical"", ""Psychological fixation"", ""targets of psychological fixation""]"	"[""Personal weapon"", ""guns"", ""Complex physical object"", ""Object"", ""Bounded entity"", ""Physical entity"", ""Entity""]"	GUNS ARE MAGICAL
"[""Making"", ""making""]"	"[""Creating"", ""creating""]"	CREATING IS MAKING
"[""Mass"", ""mass""]"	"[""Multiplex"", ""multiplicity""]"	MULTIPLICITY IS MASS
"[""Maze"", ""confusing paths to moving out of a location"", ""Physical path"", ""Motion impediments"", ""impediments to movement"", ""Impediment to motion"", ""Affected motion"", ""Causation"", ""Complex_process""]"	"[""Improving economic status"", ""impediments to improving economic status"", ""Change of state"", ""Improving a state"", ""Difficulties in action"", ""difficulties"", ""Experiencing_a_state"", ""Process""]"	IMPEDIMENTS TO IMPROVING ECONOMIC STATUS IS CONFUSING PATHS TO MOVING OUT OF A LOCATION
"[""Maze"", ""maze"", ""Physical path""]"	"[""Bureaucracy"", ""bureacracy""]"	BUREACRACY IS A MAZE
"[""Measuring"", ""measuring"", ""Dimension"", ""Quantified_mass""]"	"[""Evaluation"", ""assessing""]"	ASSESSING IS MEASURING
"[""Meeting"", ""town meeting""]"	"[""Democracy"", ""democracy""]"	DEMOCRACY IS A TOWN MEETING
"[""Money"", ""money"", ""Financial resource"", ""Resource"", ""resource"", ""entity""]"	"[""Time"", ""time""]"	TIME IS MONEY
"[""Motion along a path"", ""alternative path"", ""Motion"", ""Process""]"	"[""Legislation enactment"", ""alternative legislation"", ""Legislative action"", ""Government decision making"", ""Governing action"", ""Purposeful action"", ""Action"", ""Process"", ""Decision making""]"	ALTERNATIVE LEGISLATION IS ALTERNATIVE PATH
"[""Motion along a path"", ""change of location"", ""Motion"", ""Being at a location"", ""being at a location"", ""Process"", ""Trajector landmark"", ""Spatial relation"", ""spatial relation with an entity"", ""Figure ground""]"	"[""Change of state"", ""change of state"", ""Experiencing_a_state"", ""Process"", ""Experiencing a state"", ""experiencing a state""]"	CHANGE OF STATE IS CHANGE OF LOCATION
"[""Motion along a path"", ""distance moved along a path"", ""Motion"", ""Motion_directional"", ""Motion_scenario"", ""Process""]"	"[""Legislation enactment"", ""amount of progress toward enacting legislation"", ""Legislative action"", ""Government decision making"", ""Governing action"", ""Purposeful action"", ""Action"", ""Process"", ""Decision making""]"	AMOUNT OF PROGRESS TOWARD ENACTING LEGISLATION IS DISTANCE MOVED ALONG A PATH
"[""Motion along a path"", ""ease of motion along a path"", ""Motion"", ""Process""]"	"[""Action"", ""ease of action"", ""Process""]"	EASE OF ACTION IS EASE OF MOTION ALONG A PATH
"[""Motion along a path"", ""fixed path"", ""Motion"", ""Process""]"	"[""Curriculum"", ""curriculum"", ""Group of related ideas"", ""Category""]"	CURRICULUM IS A FIXED PATH
"[""Motion along a path"", ""impediments to motion along a path"", ""Motion"", ""Process""]"	"[""Life"", ""difficulties in progressing through life""]"	DIFFICULTIES IN PROGRESSING THROUGH LIFE ARE IMPEDIMENTS TO MOTION ALONG A PATH
"[""Motion along a path"", ""landscape through which the observer moves"", ""Motion"", ""Being at a location"", ""here"", ""Process"", ""Trajector landmark"", ""physical co-location"", ""Figure ground"", ""Spatial relation""]"	"[""Time"", ""time""]"	TIME IS A LANDSCAPE THROUGH WHICH THE OBSERVER MOVES
"[""Motion along a path"", ""motion along a path"", ""Motion"", ""Process""]"	"[""Legislative action"", ""legislative activity"", ""Governing action"", ""Purposeful action"", ""Action"", ""Process""]"	LEGISLATIVE ACTIVITY IS MOTION ALONG A PATH
"[""Motion along a path"", ""motion"", ""Motion"", ""Process""]"	"[""Governing action"", ""governing action"", ""Purposeful action"", ""Action"", ""action"", ""Process""]"	GOVERNING ACTION IS MOTION
"[""Motion along a path"", ""moving along a path"", ""Motion"", ""Process""]"	"[""Life"", ""progressing through life""]"	PROGRESSING THROUGH LIFE IS MOVING ALONG A PATH
"[""Motion along a path"", ""prevention of motion along a path"", ""Motion"", ""Force"", ""forces"", ""Process""]"	"[""Action"", ""caused inability to act"", ""Process"", ""Causation"", ""causes"", ""Complex_process""]"	CAUSED INABILITY TO ACT IS PREVENTION OF MOTION ALONG A PATH
"[""Motion along a path"", ""sequence of motions"", ""Motion"", ""Self propelled motion"", ""self-propelled motion along a path"", ""Process"", ""Affected motion"", ""Motion_along_a_path"", ""motion along a path"", ""Causation"", ""motion"", ""Complex_process""]"	"[""Life"", ""life"", ""Action"", ""action"", ""Process""]"	LIFE IS A SEQUENCE OF MOTIONS
"[""Motion along a path"", ""sequence of movements"", ""Motion"", ""Process""]"	"[""Action"", ""sequence of actions"", ""Intentionally_act"", ""Process""]"	SEQUENCE OF ACTIONS IS A SEQUENCE OF MOVEMENTS
"[""Motion along a path"", ""vertical movement"", ""Motion"", ""change of location"", ""Process"", ""Being at a location"", ""being at a location"", ""Spatial relation"", ""spatial relation with an entity"", ""Trajector landmark"", ""Figure ground""]"	"[""Emotion"", ""change in mood"", ""Experiencing a state"", ""Change of state"", ""change of state"", ""Experiencing_a_state"", ""Process"", ""experiencing a state""]"	CHANGE IN MOOD IS VERTICAL MOVEMENT
"[""Motion away from a location"", ""moving out of a location"", ""change of location""]"	"[""Improving economic status"", ""improving economic status"", ""Change of state"", ""Improving a state"", ""improving a state"", ""Experiencing_a_state"", ""Process""]"	IMPROVING ECONOMIC STATUS IS MOVING OUT OF A LOCATION
"[""Motion away from an undesirable location"", ""moving out of an undesirable location"", ""Escaping"", ""Motion with respect to an undesirable entity"", ""Motion away from a location"", ""moving out of a location"", ""change of location""]"	"[""Improving economic status"", ""improving economic status"", ""Change of state"", ""Improving a state"", ""Experiencing_a_state"", ""Process"", ""improving a state""]"	IMPROVING ECONOMIC STATUS IS MOVING OUT OF AN UNDESIRABLE LOCATION
"[""Motion impediment"", ""impediments to motion along a path""]"	"[""Romantic relationship"", ""difficulties in a romantic relationship""]"	DIFFICULTIES IN A ROMANTIC RELATIONSHIP ARE IMPEDIMENTS TO MOTION ALONG A PATH
"[""Motion impediments"", ""blocking motion"", ""Impediment to motion"", ""Affected motion"", ""Causation"", ""Complex_process""]"	"[""Legislation enactment"", ""preventing enactment of legislation"", ""Legislative action"", ""Government decision making"", ""Governing action"", ""Purposeful action"", ""Action"", ""Process"", ""Decision making""]"	PREVENTING ENACTMENT OF LEGISLATION IS BLOCKING MOTION
"[""Motion impediments"", ""impediments to motion"", ""Impediment to motion"", ""impediments to movement"", ""Affected motion"", ""Causation"", ""Complex_process""]"	"[""Taxation"", ""taxation"", ""Governing action"", ""Purposeful action"", ""Action"", ""Process""]"	TAXATION IS IMPEDIMENTS TO MOTION
"[""Motion impediments"", ""impediments to movement"", ""Impediment to motion"", ""Affected motion"", ""Causation"", ""Complex_process""]"	"[""Difficulties in action"", ""difficulties""]"	DIFFICULTIES ARE IMPEDIMENTS TO MOVEMENT
"[""Motion impediments"", ""motion impediment"", ""Impediment to motion"", ""Affected motion"", ""Causation"", ""Complex_process""]"	"[""Poverty"", ""poverty"", ""Economic status"", ""Social problems"", ""Social group"", ""Status"", ""Problem"", ""Group""]"	POVERTY IS A MOTION IMPEDIMENT
"[""Motion impediments"", ""physical impediments to motion"", ""Impediment to motion"", ""Affected motion"", ""Causation"", ""Complex_process""]"	"[""Difficulties in action"", ""impediments to action""]"	IMPEDIMENTS TO ACTION ARE PHYSICAL IMPEDIMENTS TO MOTION
"[""Motion impediments"", ""physical impediments to motion"", ""Impediment to motion"", ""Affected motion"", ""Causation"", ""Complex_process""]"	"[""Improving economic status"", ""impediments to improving economic status"", ""Change of state"", ""Improving a state"", ""Difficulties in action"", ""impediments to action"", ""Experiencing_a_state"", ""Process""]"	IMPEDIMENTS TO IMPROVING ECONOMIC STATUS IS PHYSICAL IMPEDIMENTS TO MOTION
"[""Motion impediments"", ""physical impediments to motion"", ""Impediment to motion"", ""impediments to movement"", ""Affected motion"", ""Causation"", ""Complex_process""]"	"[""Debt"", ""debt"", ""Difficulties in action"", ""difficulties""]"	DEBT IS PHYSICAL IMPEDIMENTS TO MOTION
"[""Motion to a destination"", ""amount of distance moved""]"	"[""Purposeful action"", ""amount of progress"", ""Accomplishment"", ""Action"", ""Process""]"	AMOUNT OF PROGRESS IS AMOUNT OF DISTANCE MOVED
"[""Motion to a location"", ""end of a path""]"	"[""Action"", ""end of an action"", ""Process""]"	END OF AN ACTION IS THE END OF A PATH
"[""Motion to a location"", ""motion to a preferred location"", ""Arriving""]"	"[""Improving a state"", ""improving a state"", ""Change of state"", ""Experiencing_a_state"", ""Process""]"	IMPROVING A STATE IS MOTION TO A PREFERRED LOCATION
"[""Motion to a location"", ""reaching a destination"", ""Self propelled motion to a destination""]"	"[""Gun rights"", ""achieving gun rights"", ""Rights"", ""Purposeful action"", ""achieving a purpose"", ""Action"", ""Process""]"	ACHIEVING GUN RIGHTS IS REACHING A DESTINATION
"[""Motion"", ""motion"", ""Process""]"	"[""Action"", ""action"", ""Process""]"	ACTION IS MOTION
"[""Motion"", ""moving"", ""Process""]"	"[""Thinking about"", ""thinking""]"	THINKING IS MOVING
"[""Motion-affecting objects"", ""motion impediment"", ""Motion-affecting external factors"", ""Motion impediments"", ""Impediment to motion"", ""Affected motion"", ""Causation"", ""Complex_process""]"	"[""Gun control legislation"", ""gun control regulation"", ""Gun legislation"", ""Legislation enactment"", ""Legislative action"", ""Government decision making"", ""Governing action"", ""Purposeful action"", ""Action"", ""Process"", ""Decision making""]"	GUN CONTROL REGULATION IS A MOTION IMPEDIMENT
"[""Motion_along_a_path"", ""forward motion along a path""]"	"[""Action"", ""progress"", ""Process""]"	PROGRESS IS FORWARD MOTION ALONG A PATH
"[""Motion_along_a_path"", ""motion along a path"", ""Motion"", ""motion"", ""Process""]"	"[""Action"", ""action"", ""Process""]"	ACTION IS MOTION ALONG A PATH
"[""Moving object"", ""moving object"", ""Being at a location"", ""here"", ""Being_located"", ""Trajector landmark"", ""Process"", ""physical co-location"", ""Figure ground"", ""Spatial relation""]"	"[""Time"", ""time""]"	TIME IS A MOVING OBJECT
"[""Natural disaster"", ""natural disaster"", ""Destroying"", ""Physical harm"", ""Harm"", ""Causation"", ""Complex_process""]"	"[""Personal weapon"", ""guns"", ""Complex physical object"", ""Object"", ""Bounded entity"", ""Physical entity"", ""Entity""]"	GUNS ARE A NATURAL DISASTER
"[""Natural order"", ""natural order""]"	"[""Moral order"", ""moral order""]"	MORAL ORDER IS THE NATURAL ORDER
"[""Natural process"", ""natural process"", ""Process""]"	"[""Market"", ""market"", ""Institution"", ""Organization"", ""Social group"", ""Group""]"	MARKET IS A NATURAL PROCESS
"[""Natural resource"", ""limited natural resource"", ""Resource"", ""Physical entity"", ""physical entities"", ""Entity""]"	"[""Economic resource"", ""economic resource"", ""Resource""]"	ECONOMIC RESOURCE IS A LIMITED NATURAL RESOURCE
"[""Nuclear family"", ""parent"", ""Kinship"", ""Family"", ""Person"", ""person"", ""Social group"", ""Animate entity"", ""Sentient entity"", ""Biological entity"", ""organism"", ""Group"", ""Entity"", ""Complex physical object"", ""Object"", ""Bounded entity"", ""Physical entity""]"	"[""Government"", ""government"", ""Organization"", ""Social group"", ""Group""]"	GOVERNMENT IS A PARENT
"[""Nurturance"", ""nurturance""]"	"[""Morality"", ""moral action""]"	MORAL ACTION IS NURTURANCE
"[""Nurturant parent family"", ""nurturant parent family"", ""Nuclear family"", ""Family"", ""family"", ""Social group"", ""Group""]"	"[""Liberal market"", ""liberal market"", ""Market"", ""market"", ""Institution"", ""Organization"", ""Social group"", ""Group""]"	LIBERAL MARKET IS A NURTURANT PARENT FAMILY
"[""Nurturant parent family"", ""nurturing parents"", ""Nuclear family"", ""Nurturance"", ""nurturance"", ""Family"", ""Social group"", ""Group""]"	"[""Moral action"", ""moral agents"", ""Morality"", ""moral action""]"	MORAL AGENTS ARE NURTURING PARENTS
"[""Nutritious food"", ""getting nutritious food"", ""Food"", ""Eating"", ""eating"", ""Ingestion"", ""Physical entity"", ""Consume"", ""Cognizing"", ""bodily functioning"", ""Entity"", ""Bodily functioning""]"	"[""Learning"", ""learning"", ""Becoming_aware"", ""Education_teaching"", ""Memorization"", ""Cognizing"", ""Thinking about"", ""acquiring ideas"", ""Bodily_functioning"", ""cognizing""]"	LEARNING IS GETTING NUTRITIOUS FOOD
"[""Object Construction"", ""object construction""]"	"[""Arithmetic"", ""arithmetic""]"	ARITHMETIC IS OBJECT CONSTRUCTION
"[""Object manipulation"", ""grasping"", ""Object_manipulation"", ""object manipulation"", ""Cognizing"", ""bodily functioning"", ""Mental_activity"", ""Cogitation""]"	"[""Understanding"", ""understanding"", ""Grasp"", ""Knowing"", ""Thinking about"", ""thinking"", ""Awareness"", ""Cogitation"", ""Cognizing"", ""Bodily_functioning"", ""cognizing""]"	UNDERSTANDING IS GRASPING
"[""Object manipulation"", ""object manipulation""]"	"[""Control"", ""control"", ""Complex process""]"	CONTROL IS OBJECT MANIPULATION
"[""Object manipulation"", ""physical restraint"", ""object manipulation""]"	"[""Control"", ""control"", ""Complex process""]"	CONTROL IS PHYSICAL RESTRAINT
"[""Object"", ""entrusted object"", ""Bounded entity"", ""Physical entity"", ""Entity""]"	"[""Power"", ""legitimate power""]"	LEGITIMATE POWER IS AN ENTRUSTED OBJECT
"[""Object"", ""object"", ""Bounded entity"", ""Physical entity"", ""Entity""]"	"[""Education"", ""education""]"	EDUCATION IS AN OBJECT
"[""Object"", ""object"", ""Bounded entity"", ""Physical entity"", ""Entity""]"	"[""Nation"", ""nation"", ""Political region""]"	NATION IS AN OBJECT
"[""Object"", ""objects"", ""Bounded entity"", ""Physical entity"", ""Entity""]"	"[""Emotion"", ""emotions"", ""Experiencing a state""]"	EMOTIONS ARE OBJECTS
"[""Object"", ""objects"", ""Bounded entity"", ""Physical entity"", ""Entity""]"	"[""Event"", ""events""]"	EVENTS ARE OBJECTS
"[""Object"", ""objects"", ""Bounded entity"", ""Physical entity"", ""Entity""]"	"[""Force"", ""forces""]"	FORCES ARE OBJECTS
"[""Object"", ""objects"", ""Bounded entity"", ""Physical entity"", ""Entity""]"	"[""Idea"", ""ideas""]"	IDEAS ARE OBJECTS
"[""Object"", ""objects"", ""Bounded entity"", ""Physical entity"", ""Entity""]"	"[""Law"", ""laws""]"	LAWS ARE OBJECTS
"[""Object"", ""objects"", ""Bounded entity"", ""Physical entity"", ""Entity""]"	"[""Opportunities"", ""opportunities""]"	OPPORTUNITIES ARE OBJECTS
"[""Object"", ""objects"", ""Bounded entity"", ""Physical entity"", ""Entity""]"	"[""Relationship"", ""relationships""]"	RELATIONSHIPS ARE OBJECTS
"[""Object"", ""weight"", ""Bounded entity"", ""Physical entity"", ""Entity""]"	"[""Importance"", ""importance""]"	IMPORTANCE IS WEIGHT
"[""Object_manipulation"", ""object manipulation"", ""Cognizing"", ""bodily functioning""]"	"[""Thinking about"", ""thinking"", ""Bodily_functioning"", ""cognizing""]"	THINKING IS OBJECT MANIPULATION
"[""Obscenity"", ""obscene"", ""Immorality"", ""Impurity"", ""impurity""]"	"[""Wealth"", ""excess wealth"", ""Economic status"", ""Immorality"", ""immorality"", ""Social group"", ""Status"", ""Group""]"	EXCESS WEALTH IS OBSCENE
"[""Operating a machine"", ""functioning machine""]"	"[""Legislative action"", ""functional legislature"", ""Governing action"", ""Purposeful action"", ""Action"", ""Process""]"	FUNCTIONAL LEGISLATURE IS A FUNCTIONING MACHINE
"[""Overeating"", ""eating too much food"", ""Eating"", ""Ingestion"", ""Consume"", ""Bodily functioning""]"	"[""Resource consumption"", ""consuming too many resources""]"	CONSUMING TOO MANY RESOURCES IS EATING TOO MUCH FOOD
"[""Parasite"", ""leech"", ""Blood-sucking creature"", ""Biological entity"", ""organism"", ""Animate entity"", ""Complex physical object"", ""Object"", ""Bounded entity"", ""Physical entity"", ""Entity""]"	"[""Government"", ""government"", ""Organization"", ""Social group"", ""Group""]"	GOVERNMENT IS A LEECH
"[""Parasite"", ""leeches"", ""Blood-sucking creature"", ""Animate entity"", ""Biological entity"", ""Complex physical object"", ""Object"", ""Bounded entity"", ""Physical entity"", ""Entity""]"	"[""Impoverished"", ""entitlement holders"", ""Experiencing a negative state"", ""Experiencing an economic status"", ""Limited resource"", ""exploitation of resources"", ""Experiencing a state""]"	ENTITLEMENT HOLDERS ARE LEECHES
"[""Parasite"", ""parasitic infection"", ""Blood-sucking creature"", ""Animate entity"", ""Biological entity"", ""Complex physical object"", ""Object"", ""Bounded entity"", ""Physical entity"", ""Entity""]"	"[""Limited resource"", ""exploitation of resources""]"	EXPLOITATION OF RESOURCES IS A PARASITIC INFECTION
"[""Parasite"", ""termite infestation"", ""Blood-sucking creature"", ""Destructive_natural_process"", ""destructive natural process"", ""Animate entity"", ""Biological entity"", ""Complex physical object"", ""Object"", ""Bounded entity"", ""Physical entity"", ""Entity"", ""Destructive force"", ""destructive force"", ""Force"", ""forces""]"	"[""Corruption"", ""corruption""]"	CORRUPTION IS A TERMITE INFESTATION
"[""Parental_authority"", ""parental authority""]"	"[""Moral_authority"", ""moral authority""]"	MORAL AUTHORITY IS PARENTAL AUTHORITY
"[""Part whole"", ""wholeness""]"	"[""Morality"", ""morality"", ""Morality_evaluation""]"	MORALITY IS WHOLENESS
"[""Part_whole"", ""part-whole structures""]"	"[""Group"", ""groups""]"	GROUPS ARE PART-WHOLE STRUCTURES
"[""Partnership"", ""equal partnership""]"	"[""Democracy"", ""democracy""]"	DEMOCRACY IS AN EQUAL PARTNERSHIP
"[""Paths out of a location"", ""paths to moving out of a location"", ""Physical path"", ""Self propelled motion to a destination"", ""paths"", ""Motion to a location""]"	"[""Improving economic status"", ""means of improving economic status"", ""Change of state"", ""Improving a state"", ""Purposeful action"", ""means"", ""Experiencing_a_state"", ""Process"", ""Action""]"	MEANS OF IMPROVING ECONOMIC STATUS ARE PATHS TO MOVING OUT OF A LOCATION
"[""Perception"", ""perceiving"", ""Cognizing"", ""bodily functioning""]"	"[""Knowing"", ""knowing"", ""Cognizing"", ""Bodily_functioning"", ""cognizing""]"	KNOWING IS PERCEIVING
"[""Perception"", ""perceiving"", ""Perception_experience""]"	"[""Thinking about"", ""thinking""]"	THINKING IS PERCEIVING
"[""Persistence"", ""remaining erect"", ""Building"", ""buildings"", ""Physical structure"", ""Complex physical object"", ""Object"", ""objects"", ""complex structures"", ""Bounded entity"", ""Physical entity"", ""Entity""]"	"[""Erectness"", ""persisting"", ""Theory"", ""theories"", ""Idea"", ""ideas""]"	PERSISTING IS REMAINING ERECT
"[""Person"", ""eyes and ears"", ""Animate entity"", ""Sentient entity"", ""Body"", ""body"", ""Biological entity"", ""Entity"", ""Complex physical object"", ""Object"", ""Bounded entity"", ""Physical entity""]"	"[""Government"", ""citizens"", ""Organization"", ""Nation"", ""nation"", ""Social group"", ""Group"", ""Political region""]"	CITIZENS ARE EYES AND EARS
"[""Person"", ""people"", ""Animate entity"", ""Sentient entity"", ""Biological entity"", ""Entity"", ""Complex physical object"", ""Object"", ""Bounded entity"", ""Physical entity""]"	"[""Computer"", ""computers"", ""Machine"", ""machines"", ""Physical structure"", ""Complex physical object"", ""Object"", ""Bounded entity"", ""Physical entity"", ""Entity""]"	COMPUTERS ARE PEOPLE
"[""Person"", ""people"", ""Animate entity"", ""Sentient entity"", ""Biological entity"", ""Entity"", ""Complex physical object"", ""Object"", ""Bounded entity"", ""Physical entity""]"	"[""Corporation"", ""corporations"", ""Institution"", ""Organization"", ""Social group"", ""Group""]"	CORPORATIONS ARE PEOPLE
"[""Person"", ""people"", ""Animate entity"", ""Sentient entity"", ""Biological entity"", ""Entity"", ""Complex physical object"", ""Object"", ""Bounded entity"", ""Physical entity""]"	"[""Machine"", ""machines"", ""Physical structure"", ""Complex physical object"", ""Object"", ""Bounded entity"", ""Physical entity"", ""Entity""]"	MACHINES ARE PEOPLE
"[""Person"", ""people"", ""Animate entity"", ""Sentient entity"", ""Biological entity"", ""Entity"", ""Complex physical object"", ""Object"", ""Bounded entity"", ""Physical entity""]"	"[""Political party"", ""political parties""]"	POLITICAL PARTIES ARE PEOPLE
"[""Person"", ""people"", ""Animate entity"", ""Sentient entity"", ""Biological entity"", ""organism"", ""Entity"", ""Complex physical object"", ""complex physical object"", ""Object"", ""Bounded entity"", ""Physical entity""]"	"[""Institution"", ""institutions"", ""Organization"", ""Social group"", ""Group""]"	INSTITUTIONS ARE PEOPLE
"[""Person"", ""people"", ""Animate entity"", ""Sentient entity"", ""living entities"", ""Biological entity"", ""Entity"", ""Complex physical object"", ""Object"", ""Bounded entity"", ""Physical entity""]"	"[""Idea"", ""ideas""]"	IDEAS ARE PEOPLE
"[""Person"", ""person"", ""Animate entity"", ""Sentient entity"", ""Biological entity"", ""Entity"", ""Complex physical object"", ""Object"", ""Bounded entity"", ""Physical entity""]"	"[""Nation"", ""nation"", ""Political region""]"	NATION IS A PERSON
"[""Person"", ""person"", ""Animate entity"", ""Sentient entity"", ""Biological entity"", ""organism"", ""Entity"", ""Complex physical object"", ""Object"", ""Bounded entity"", ""Physical entity""]"	"[""Government"", ""government"", ""Organization"", ""Social group"", ""Group""]"	GOVERNMENT IS A PERSON
"[""Person"", ""person"", ""People"", ""Animate entity"", ""Sentient entity"", ""Biological entity"", ""Entity"", ""Complex physical object"", ""Object"", ""Bounded entity"", ""Physical entity""]"	"[""Society"", ""society""]"	SOCIETY IS A PERSON
"[""Person"", ""physical health"", ""Animate entity"", ""Sentient entity"", ""person"", ""Biological entity"", ""Entity"", ""Complex physical object"", ""Object"", ""Bounded entity"", ""Physical entity""]"	"[""Society"", ""social functioning"", ""society""]"	SOCIAL FUNCTIONING IS PHYSICAL HEALTH
"[""Pest"", ""pests"", ""Biological entity"", ""living entities"", ""Complex physical object"", ""Object"", ""Bounded entity"", ""Physical entity"", ""Entity""]"	"[""Personal weapon"", ""guns"", ""Complex physical object"", ""Object"", ""Bounded entity"", ""Physical entity"", ""Entity""]"	GUNS ARE PESTS
"[""Physical affliction"", ""experiencing a physical affliction"", ""Harm to living entity"", ""physical afflictions"", ""Physical harm"", ""Harm"", ""Causation"", ""Complex_process""]"	"[""Improving economic status"", ""impediments to improving economic status"", ""Change of state"", ""Improving a state"", ""Social problems"", ""social problems"", ""Experiencing_a_state"", ""Process"", ""Problem""]"	IMPEDIMENTS TO IMPROVING ECONOMIC STATUS IS EXPERIENCING A PHYSICAL AFFLICTION
"[""Physical affliction"", ""physical affliction"", ""Harm to living entity"", ""Physical harm"", ""Harm"", ""Causation"", ""Complex_process""]"	"[""Injurious gun use"", ""gun violence"", ""Social problems"", ""Harm to living entity"", ""social problems"", ""Problem"", ""Physical harm"", ""Harm"", ""Causation"", ""Complex_process""]"	GUN VIOLENCE IS A PHYSICAL AFFLICTION
"[""Physical affliction"", ""physical afflictions"", ""Harm to living entity"", ""Physical harm"", ""Harm"", ""Causation"", ""Complex_process""]"	"[""Social problems"", ""social problems"", ""Problem""]"	SOCIAL PROBLEMS ARE PHYSICAL AFFLICTIONS
"[""Physical combat"", ""adversaries""]"	"[""Ideology"", ""differing ideologies""]"	DIFFERING IDEOLOGIES ARE ADVERSARIES
"[""Physical combat"", ""one-on-one physical fighting"", ""physical combat"", ""physical conflict""]"	"[""Debating"", ""debating"", ""Discussing"", ""Argument"", ""argument"", ""psychological conflict""]"	DEBATING IS ONE-ON-ONE PHYSICAL FIGHTING
"[""Physical combat"", ""physical combat"", ""physical conflict""]"	"[""Argument"", ""argument"", ""psychological conflict""]"	ARGUMENT IS PHYSICAL COMBAT
"[""Physical combat"", ""physical combat"", ""physical conflict""]"	"[""Social class"", ""class interaction"", ""Argument"", ""argument"", ""psychological conflict""]"	CLASS INTERACTION IS PHYSICAL COMBAT
"[""Physical combat"", ""physical combat""]"	"[""Advocacy"", ""advocacy"", ""Argument"", ""argument"", ""psychological conflict""]"	ADVOCACY IS PHYSICAL COMBAT
"[""Physical combat"", ""physical combat""]"	"[""Cancer"", ""cancer"", ""Disease"", ""Physical affliction"", ""Harm to living entity"", ""Physical harm"", ""Harm"", ""Causation"", ""Complex_process""]"	CANCER IS PHYSICAL COMBAT
"[""Physical combat"", ""physical combatant""]"	"[""Cancer patient"", ""cancer patient""]"	CANCER PATIENT IS PHYSICAL COMBATANT
"[""Physical combat"", ""waging war""]"	"[""Addressing poverty"", ""addressing poverty"", ""Addressing social problems"", ""addressing social problems"", ""Causation"", ""Complex_process"", ""Negatively evaluated condition"", ""negatively evaluated conditions"", ""State""]"	ADDRESSING POVERTY IS WAGING WAR
"[""Physical competition"", ""boxing match"", ""Competition"", ""Competitive sport"", ""competitive sports events"", ""Recreational competition"", ""Game"", ""game""]"	"[""Election"", ""election"", ""Political competition"", ""Competition""]"	ELECTION IS A BOXING MATCH
"[""Physical competition"", ""losing a boxing match"", ""Competition""]"	"[""Election"", ""losing an election"", ""Political competition"", ""Competition""]"	LOSING AN ELECTION IS LOSING A BOXING MATCH
"[""Physical competition"", ""winning a boxing match"", ""Competition""]"	"[""Election"", ""winning an election"", ""Political competition"", ""Competition""]"	WINNING AN ELECTION IS WINNING A BOXING MATCH
"[""Physical connection"", ""physical interconnectedness"", ""Connectors"", ""Attaching""]"	"[""Spatial relation"", ""interrelatedness""]"	INTERRELATEDNESS IS PHYSICAL INTERCONNECTEDNESS
"[""Physical entity"", ""physical entities"", ""Entity""]"	"[""Economic resource"", ""economic resources"", ""Resource""]"	ECONOMIC RESOURCES ARE PHYSICAL ENTITIES
"[""Physical entity"", ""physical entities"", ""Entity""]"	"[""Rights"", ""rights""]"	RIGHTS ARE PHYSICAL ENTITIES
"[""Physical entity"", ""physical objects"", ""Entity""]"	"[""State"", ""states""]"	STATES ARE PHYSICAL OBJECTS
"[""Physical harm"", ""causing harm to a physical structure"", ""Harm"", ""Causation"", ""Complex_process""]"	"[""Law"", ""negatively affecting a law""]"	NEGATIVELY AFFECTING A LAW IS CAUSING HARM TO A PHYSICAL STRUCTURE
"[""Physical harm"", ""causing harm"", ""Harm"", ""Causation"", ""Complex_process""]"	"[""Taxation"", ""taxation"", ""Governing action"", ""Purposeful action"", ""Action"", ""Process""]"	TAXATION IS CAUSING HARM
"[""Physical harm"", ""experiencing harm"", ""Harm"", ""Causation"", ""Complex_process""]"	"[""Experiencing a negative state"", ""experiencing a negative state"", ""Experiencing a state""]"	EXPERIENCING A NEGATIVE STATE IS EXPERIENCING HARM
"[""Physical harm"", ""physical harm"", ""Harm"", ""Causation"", ""Complex_process""]"	"[""Advocacy"", ""gun control advocacy"", ""advocacy""]"	GUN CONTROL ADVOCACY IS PHYSICAL HARM
"[""Physical harm"", ""physical harm"", ""Harm"", ""Causation"", ""Complex_process""]"	"[""Economic difficulty"", ""economic hardship"", ""Difficulty"", ""Negatively evaluated condition"", ""negatively evaluated conditions"", ""State""]"	ECONOMIC HARDSHIP IS PHYSICAL HARM
"[""Physical harm"", ""physical harm"", ""Harm"", ""Causation"", ""Complex_process""]"	"[""Gun control"", ""gun control regulation"", ""Control"", ""Complex process""]"	GUN CONTROL REGULATION IS PHYSICAL HARM
"[""Physical harm"", ""physical harm"", ""Harm"", ""Causation"", ""Complex_process""]"	"[""Injurious gun use"", ""gun violence"", ""Social problems"", ""Harm to living entity"", ""Problem"", ""Physical harm"", ""Harm"", ""Causation"", ""Complex_process""]"	GUN VIOLENCE IS PHYSICAL HARM
"[""Physical harm"", ""physical harm"", ""Harm"", ""Causation"", ""Complex_process""]"	"[""Poverty"", ""poverty"", ""Economic status"", ""Social problems"", ""Economic difficulty"", ""economic hardship"", ""Social group"", ""Status"", ""Problem"", ""Difficulty"", ""Negatively evaluated condition"", ""negatively evaluated conditions"", ""Group"", ""State""]"	POVERTY IS PHYSICAL HARM
"[""Physical harm"", ""physical injury"", ""Harm"", ""Causation"", ""Complex_process""]"	"[""Environmental harm"", ""environmental harm"", ""Harm"", ""harm"", ""Causation"", ""Complex_process""]"	ENVIRONMENTAL HARM IS PHYSICAL INJURY
"[""Physical harm"", ""physical injury"", ""Harm"", ""Causation"", ""Complex_process""]"	"[""Harm"", ""harm"", ""Causation"", ""Complex_process""]"	HARM IS PHYSICAL INJURY
"[""Physical harm"", ""physical injury"", ""Harm"", ""Causation"", ""Complex_process""]"	"[""Psychological harm"", ""psychological harm"", ""Harm"", ""harm"", ""Causation"", ""Complex_process""]"	PSYCHOLOGICAL HARM IS PHYSICAL INJURY
"[""Physical impediments to motion"", ""lack of impediments to movement""]"	"[""Freedom of action"", ""freedom of action""]"	FREEDOM OF ACTION IS THE LACK OF IMPEDIMENTS TO MOVEMENT
"[""Physical path"", ""paths""]"	"[""Opportunities"", ""opportunities""]"	OPPORTUNITIES ARE PATHS
"[""Physical Restraining of Mouth"", ""physical restraining of mouth""]"	"[""Censorship"", ""censorship""]"	CENSORSHIP IS PHYSICAL RESTRAINING OF MOUTH
"[""Physical strength"", ""bodily strength""]"	"[""government power""]"	GOVERNMENT POWER IS BODILY STRENGTH
"[""Physical strength"", ""strength""]"	"[""Morality"", ""morality""]"	MORALITY IS STRENGTH
"[""Physical strength"", ""stronger physical restraint""]"	"[""Gun control legislation"", ""greater degree of gun control"", ""Gun legislation"", ""Legislation enactment"", ""Legislative action"", ""Government decision making"", ""Governing action"", ""Purposeful action"", ""Action"", ""Process"", ""Decision making""]"	GREATER DEGREE OF GUN CONTROL IS STRONGER PHYSICAL RESTRAINT
"[""Physical structure"", ""damaging a physical structure"", ""Complex physical object"", ""Object"", ""Bounded entity"", ""Physical entity"", ""Entity""]"	"[""Rights"", ""government's harmful treatment of rights""]"	GOVERNMENT'S HARMFUL TREATMENT OF RIGHTS IS DAMAGING A PHYSICAL STRUCTURE
"[""Physical structure"", ""physical structure"", ""Complex physical object"", ""Object"", ""Bounded entity"", ""Physical entity"", ""Entity""]"	"[""Government institution"", ""government institution"", ""Institution"", ""institution"", ""Organization"", ""Social group"", ""Group"", ""social groups"", ""organization""]"	GOVERNMENT INSTITUTION IS A PHYSICAL STRUCTURE
"[""Physical structure"", ""physical structure"", ""Complex physical object"", ""Object"", ""Bounded entity"", ""Physical entity"", ""Entity""]"	"[""Mind"", ""mind""]"	MIND IS A PHYSICAL STRUCTURE
"[""Physical structure"", ""physical structure"", ""Complex physical object"", ""Object"", ""Bounded entity"", ""Physical entity"", ""Entity""]"	"[""Organization"", ""organization"", ""Social group"", ""Group""]"	ORGANIZATION IS PHYSICAL STRUCTURE
"[""Physical structure"", ""physical structures"", ""Complex physical object"", ""complex structures"", ""Object"", ""objects"", ""Bounded entity"", ""Physical entity"", ""Entity""]"	"[""Relationship"", ""relationships""]"	RELATIONSHIPS ARE PHYSICAL STRUCTURES
"[""Physical structure"", ""physical structures"", ""Complex physical object"", ""Object"", ""Bounded entity"", ""Physical entity"", ""Entity""]"	"[""Rights"", ""citizen rights"", ""rights""]"	CITIZEN RIGHTS ARE PHYSICAL STRUCTURES
"[""Physical structure"", ""physical structures"", ""Complex physical object"", ""Object"", ""objects"", ""Bounded entity"", ""Physical entity"", ""Entity""]"	"[""Law"", ""laws""]"	LAWS ARE PHYSICAL STRUCTURES
"[""Physical struggle"", ""physical struggle""]"	"[""Difficulties in action"", ""difficulty""]"	DIFFICULTY IS PHYSICAL STRUGGLE
"[""Physical weakness"", ""weaker physical restraint"", ""Restraints"", ""physical restraint"", ""Motion-affecting objects"", ""Motion-affecting external factors"", ""Motion impediments"", ""Impediment to motion"", ""Affected motion"", ""Causation"", ""Complex_process""]"	"[""Gun control legislation"", ""lesser degree of gun control legislation"", ""Gun legislation"", ""gun control legislation"", ""Legislation enactment"", ""Legislative action"", ""Government decision making"", ""Governing action"", ""Purposeful action"", ""Action"", ""Process"", ""Decision making"", ""Law"", ""laws"", ""Gun control"", ""gun control"", ""Control"", ""control"", ""Complex process""]"	LESSER DEGREE OF GUN CONTROL LEGISLATION IS WEAKER PHYSICAL RESTRAINT
"[""Placing in a protected location"", ""placing objects in protected location"", ""Hiding"", ""Physical entity"", ""physical entities"", ""Entity""]"	"[""Taxation"", ""keeping assets from being taxed"", ""Governing action"", ""Economic resource"", ""economic resources"", ""Purposeful action"", ""Resource"", ""Action"", ""Process""]"	KEEPING ASSETS FROM BEING TAXED IS PLACING OBJECTS IN PROTECTED LOCATION
"[""Plants"", ""plant"", ""Biological entity"", ""Complex physical object"", ""Object"", ""Bounded entity"", ""Physical entity"", ""Entity""]"	"[""Poverty"", ""poverty"", ""Economic status"", ""Social problems"", ""Social group"", ""Status"", ""Problem"", ""Group""]"	POVERTY IS A PLANT
"[""Plants"", ""plant"", ""Biological entity"", ""living entities"", ""Complex physical object"", ""Object"", ""Bounded entity"", ""Physical entity"", ""Entity""]"	"[""Democratic ideology"", ""democracy"", ""Ideology"", ""political ideologies""]"	DEMOCRACY IS A PLANT
"[""Plants"", ""plants"", ""Biological entity"", ""Animate entity"", ""living entities"", ""Complex physical object"", ""Object"", ""Bounded entity"", ""Physical entity"", ""Entity""]"	"[""Law"", ""laws""]"	LAWS ARE PLANTS
"[""Plants"", ""plants"", ""Biological entity"", ""Complex physical object"", ""Object"", ""Bounded entity"", ""Physical entity"", ""Entity""]"	"[""Person"", ""people"", ""Animate entity"", ""Sentient entity"", ""Biological entity"", ""Entity"", ""Complex physical object"", ""Object"", ""Bounded entity"", ""Physical entity""]"	PEOPLE ARE PLANTS
"[""Plants"", ""plants"", ""Planting"", ""Biological entity"", ""Complex physical object"", ""Object"", ""Bounded entity"", ""Physical entity"", ""Entity""]"	"[""Organization"", ""social organizations"", ""Social group"", ""Group""]"	SOCIAL ORGANIZATIONS ARE PLANTS
"[""Portals"", ""portals""]"	"[""Opportunities"", ""opportunities""]"	OPPORTUNITIES ARE PORTALS
"[""Possessable object"", ""possessions"", ""Object"", ""Physical entity"", ""physical entities"", ""Bounded entity"", ""Entity""]"	"[""Rights"", ""rights""]"	RIGHTS ARE POSSESSIONS
"[""Possessable object"", ""valuable possessions"", ""Object"", ""Bounded entity"", ""Physical entity"", ""Entity""]"	"[""Gun rights"", ""gun rights"", ""Rights"", ""citizen rights"", ""rights""]"	GUN RIGHTS ARE VALUABLE POSSESSIONS
"[""Possession change"", ""change of possession"", ""Getting_scenario"", ""Lose_possession_scenario"", ""Possession"", ""possessing an object"", ""Spatial relation"", ""spatial relation with an entity""]"	"[""Change of state"", ""change of state"", ""Experiencing_a_state"", ""Process"", ""Experiencing a state"", ""experiencing a state""]"	CHANGE OF STATE IS CHANGE OF POSSESSION
"[""Possession"", ""possessed object""]"	"[""Power"", ""power""]"	POWER IS A POSSESSED OBJECT
"[""Possession"", ""possessing an object"", ""Spatial relation"", ""spatial relation with an entity""]"	"[""Experiencing a state"", ""experiencing a state""]"	EXPERIENCING A STATE IS POSSESSING AN OBJECT
"[""Possession"", ""possessing an object""]"	"[""Rights"", ""enjoying a right""]"	ENJOYING A RIGHT IS POSSESSING AN OBJECT
"[""Possession"", ""possession""]"	"[""Control"", ""control"", ""Complex process""]"	CONTROL IS A POSSESSION
"[""Possession"", ""possessions"", ""Object"", ""objects"", ""Bounded entity"", ""Physical entity"", ""Entity""]"	"[""Belief"", ""beliefs"", ""Cognizing"", ""Idea"", ""ideas""]"	BELIEFS ARE POSSESSIONS
"[""Possession"", ""possessions"", ""Object"", ""objects"", ""Bounded entity"", ""Physical entity"", ""Entity""]"	"[""Idea"", ""ideas""]"	IDEAS ARE POSSESSIONS
"[""Possession"", ""possessions"", ""Physical entity"", ""physical objects"", ""Entity""]"	"[""Attribute"", ""attributes"", ""Attributes"", ""State"", ""states""]"	ATTRIBUTES ARE POSSESSIONS
"[""Possession"", ""possessions""]"	"[""Rights"", ""citizen rights"", ""rights""]"	CITIZEN RIGHTS ARE POSSESSIONS
"[""Possession"", ""possessors""]"	"[""Group"", ""groups""]"	GROUPS ARE POSSESSORS
"[""Possession"", ""possessors""]"	"[""Part whole"", ""wholes"", ""Part_whole""]"	WHOLES ARE POSSESSORS
"[""Possession"", ""precious possession""]"	"[""Life"", ""life""]"	LIFE IS A PRECIOUS POSSESSION
"[""Possession"", ""valuable possession""]"	"[""Freedom"", ""freedom""]"	FREEDOM IS A VALUABLE POSSESSION
"[""Pressure in a container"", ""pressure in a container"", ""Containment""]"	"[""Emotion"", ""emotion"", ""Experiencing a state""]"	EMOTION IS PRESSURE IN A CONTAINER
"[""Pressure_in_a_container"", ""pressure in a container"", ""Substance"", ""substances"", ""physical entity""]"	"[""Anger"", ""anger"", ""Emotion"", ""emotions"", ""emotion"", ""Experiencing a state""]"	ANGER IS PRESSURE IN A CONTAINER
"[""Protect against contact"", ""protection against harm""]"	"[""Wealth"", ""wealth"", ""Economic status"", ""Social group"", ""Status"", ""Group""]"	WEALTH IS PROTECTION AGAINST HARM
"[""Protect against contact"", ""shielding from physical harm""]"	"[""Economic difficulty"", ""preventing economic hardship"", ""Difficulty""]"	PREVENTING ECONOMIC HARDSHIP IS SHIELDING FROM PHYSICAL HARM
"[""Protecting"", ""shields from harm"", ""Physical entity"", ""physical entities"", ""Entity""]"	"[""Rights"", ""rights""]"	RIGHTS ARE SHIELDS FROM HARM
"[""Protecting"", ""shields from harm""]"	"[""Citizen rights"", ""citizen rights"", ""Rights"", ""rights""]"	CITIZEN RIGHTS ARE SHIELDS FROM HARM
"[""Proximal distal"", ""proximity"", ""Within_distance"", ""Bounded region"", ""Region""]"	"[""Similarity"", ""similarity""]"	SIMILARITY IS PROXIMITY
"[""Proximity"", ""degree of proximity""]"	"[""Similarity"", ""degree of similarity""]"	DEGREE OF SIMILARITY IS DEGREE OF PROXIMITY
"[""Proximity"", ""physical proximity""]"	"[""Agreement"", ""agreement""]"	AGREEMENT IS PHYSICAL PROXIMITY
"[""Proximity"", ""physical proximity""]"	"[""Intimacy"", ""emotional intimacy""]"	EMOTIONAL INTIMACY IS PHYSICAL PROXIMITY
"[""Proximity"", ""proximity"", ""Proximity_image_frame""]"	"[""Abstract relatedness"", ""relatedness""]"	RELATEDNESS IS PROXIMITY
"[""Psychological fixation"", ""targets of psychological fixation""]"	"[""Personal weapon"", ""guns"", ""Complex physical object"", ""Object"", ""Bounded entity"", ""Physical entity"", ""Entity""]"	GUNS ARE TARGETS OF PSYCHOLOGICAL FIXATION
"[""Punishment"", ""punishment"", ""Rewards_and_punishments"", ""Physical harm"", ""causing harm"", ""Harm"", ""Causation"", ""Complex_process""]"	"[""Taxation"", ""taxation"", ""Governing action"", ""Purposeful action"", ""Action"", ""Process""]"	TAXATION IS PUNISHMENT
"[""Purity"", ""purity""]"	"[""Morality"", ""morality""]"	MORALITY IS PURITY
"[""Race"", ""leg in a race"", ""Recreational competition"", ""Competition""]"	"[""Election"", ""phase of an election"", ""Political competition"", ""Competition""]"	PHASE OF AN ELECTION IS LEG IN A RACE
"[""Race"", ""losing a race"", ""Recreational competition"", ""Competition""]"	"[""Election"", ""losing an election"", ""Political competition"", ""Competition""]"	LOSING AN ELECTION IS LOSING A RACE
"[""Race"", ""race"", ""Recreational competition"", ""Competition""]"	"[""Competition"", ""competition""]"	COMPETITION IS A RACE
"[""Race"", ""race"", ""Recreational competition"", ""Competitive sport"", ""competitive sports events"", ""Competition"", ""Game"", ""game""]"	"[""Election"", ""election"", ""Political competition"", ""Competition""]"	ELECTION IS A RACE
"[""Race"", ""winning a race"", ""Recreational competition"", ""Competition""]"	"[""Election"", ""winning an election"", ""Political competition"", ""Competition""]"	WINNING AN ELECTION IS WINNING A RACE
"[""Relationship"", ""interpersonal relationships""]"	"[""International Relations"", ""international relations""]"	INTERNATIONAL RELATIONS ARE INTERPERSONAL RELATIONSHIPS
"[""Relationship"", ""partnership decision-making""]"	"[""Democracy"", ""democratic decision-making""]"	DEMOCRATIC DECISION-MAKING IS PARTNERSHIP DECISION-MAKING
"[""Release liquid"", ""forceful removal of a substance"", ""Fluid motion"", ""Motion"", ""Process""]"	"[""Taxation"", ""taxation"", ""Governing action"", ""Purposeful action"", ""Action"", ""Process""]"	TAXATION IS FORCEFUL REMOVAL OF A SUBSTANCE
"[""Resource container"", ""container"", ""Containers"", ""Containing""]"	"[""Nation"", ""nation"", ""Political region""]"	NATION IS CONTAINER
"[""Resource transfer"", ""resource transfer"", ""Transfer scenario"", ""Resource"", ""resource"", ""Complex process""]"	"[""Wealth redistribution"", ""wealth redistribution"", ""Resource transfer"", ""Wealth"", ""wealth"", ""Transfer scenario"", ""Economic status"", ""Complex process"", ""Social group"", ""Status"", ""Group""]"	WEALTH REDISTRIBUTION IS RESOURCE TRANSFER
"[""Resource"", ""physical resources""]"	"[""Finance"", ""financial resources""]"	FINANCIAL RESOURCES ARE PHYSICAL RESOURCES
"[""Resource"", ""providing a resource"", ""resource"", ""Object"", ""object"", ""Bounded entity"", ""Physical entity"", ""Entity""]"	"[""Educational opportunities"", ""provide educational opportunity"", ""Opportunities"", ""Education"", ""education""]"	PROVIDE EDUCATIONAL OPPORTUNITY IS PROVIDING A RESOURCE
"[""Resource"", ""resource"", ""entity""]"	"[""Time"", ""time""]"	TIME IS A RESOURCE
"[""Resource"", ""resource"", ""Object"", ""object"", ""Bounded entity"", ""Physical entity"", ""Entity""]"	"[""Education"", ""education""]"	EDUCATION IS A RESOURCE
"[""Resource"", ""resource""]"	"[""Labor"", ""labor""]"	LABOR IS A RESOURCE
"[""Resource"", ""resource""]"	"[""Nature"", ""nature""]"	NATURE IS A RESOURCE
"[""Resource"", ""resource""]"	"[""Wealth"", ""wealth"", ""Economic status"", ""Social group"", ""Status"", ""Group""]"	WEALTH IS A RESOURCE
"[""Restraints"", ""physical restraint"", ""Motion-affecting objects"", ""Motion-affecting external factors"", ""Motion impediments"", ""Impediment to motion"", ""Affected motion"", ""Causation"", ""Complex_process""]"	"[""Gun control legislation"", ""gun control legislation"", ""Gun legislation"", ""Law"", ""laws"", ""Gun control"", ""gun control"", ""Legislation enactment"", ""Legislative action"", ""Government decision making"", ""Governing action"", ""Purposeful action"", ""Action"", ""Process"", ""Decision making"", ""Control"", ""control"", ""Complex process""]"	GUN CONTROL LEGISLATION IS PHYSICAL RESTRAINT
"[""Restraints"", ""physical restraints"", ""Motion-affecting objects"", ""Motion-affecting external factors"", ""Motion impediments"", ""Impediment to motion"", ""Affected motion"", ""Causation"", ""Complex_process""]"	"[""Law"", ""laws""]"	LAWS ARE PHYSICAL RESTRAINTS
"[""Scale"", ""being at a point on a linear scale"", ""State"", ""Being at a location"", ""being at a location"", ""Trajector landmark"", ""Process"", ""Spatial relation"", ""spatial relation with an entity"", ""Figure ground""]"	"[""Experiencing a state"", ""being in a state""]"	BEING IN A STATE IS BEING AT A POINT ON A LINEAR SCALE
"[""Scale"", ""linear spatial scale"", ""State""]"	"[""Wealth"", ""wealth"", ""Economic status"", ""Social group"", ""Status"", ""Group""]"	WEALTH IS LINEAR SPATIAL SCALE
"[""Scale"", ""point on a scale"", ""State""]"	"[""Economic status"", ""economic status"", ""Social group"", ""Status"", ""Experiencing a state"", ""being in a state"", ""Group""]"	ECONOMIC STATUS IS A POINT ON A SCALE
"[""Searching"", ""searching"", ""Perception"", ""perceiving"", ""Cognizing"", ""bodily functioning""]"	"[""Knowing"", ""seeking knowledge"", ""Cognizing"", ""knowing"", ""Bodily_functioning"", ""cognizing""]"	SEEKING KNOWLEDGE IS SEARCHING
"[""Seeing"", ""ability to see"", ""Perception""]"	"[""Evaluation"", ""ability to evaluate"", ""Knowing"", ""ability to know"", ""Cognizing""]"	ABILITY TO EVALUATE IS ABILITY TO SEE
"[""Seeing"", ""ability to see"", ""Perception""]"	"[""Knowing"", ""ability to know"", ""Cognizing""]"	ABILITY TO KNOW IS ABILITY TO SEE
"[""Seeing"", ""ability to see"", ""Perception_experience"", ""Perception""]"	"[""Citizen evaluation of government"", ""ability to evaluate government"", ""Evaluation"", ""ability to evaluate"", ""Assessing"", ""Knowing"", ""ability to know"", ""Awareness"", ""Cognizing""]"	ABILITY TO EVALUATE GOVERNMENT IS ABILITY TO SEE
"[""Seeing"", ""light source"", ""Perception""]"	"[""Knowing"", ""aid to knowing"", ""Cognizing""]"	AID TO KNOWING IS A LIGHT SOURCE
"[""Seeing"", ""seeing"", ""Perception"", ""perceiving"", ""Cognizing"", ""bodily functioning""]"	"[""Knowing"", ""knowing"", ""Cognizing""]"	KNOWING IS SEEING
"[""Self propelled motion to a destination"", ""different paths to a destination"", ""Motion to a location""]"	"[""Purposeful action"", ""different means of achieving a purpose"", ""Action"", ""Process""]"	DIFFERENT MEANS OF ACHIEVING A PURPOSE ARE DIFFERENT PATHS TO A DESTINATION
"[""Self propelled motion to a destination"", ""goal-directed motion"", ""Motion to a location""]"	"[""Thinking about"", ""purposeful thinking""]"	PURPOSEFUL THINKING IS GOAL-DIRECTED MOTION
"[""Self propelled motion to a destination"", ""paths"", ""Motion to a location""]"	"[""Purposeful action"", ""means"", ""Action"", ""Process""]"	MEANS ARE PATHS
"[""Self propelled motion to a destination"", ""reaching a destination"", ""Motion to a location""]"	"[""Purposeful action"", ""achieving a purpose"", ""Action"", ""Process""]"	ACHIEVING A PURPOSE IS REACHING A DESTINATION
"[""Self propelled motion to a destination"", ""self-propelled motion to a destination"", ""Motion to a location""]"	"[""Purposeful action"", ""purposeful action"", ""Action"", ""Process""]"	PURPOSEFUL ACTION IS SELF-PROPELLED MOTION TO A DESTINATION
"[""Self propelled motion to a destination"", ""self-propelled motion"", ""Motion to a location"", ""Motion along a path"", ""change of location"", ""Motion"", ""Being at a location"", ""being at a location"", ""Process"", ""Trajector landmark"", ""Spatial relation"", ""spatial relation with an entity"", ""Figure ground""]"	"[""Self-initiated state change"", ""self-initiated state change"", ""Change of state"", ""Purposeful action"", ""change of state"", ""Change_of_state_endstate"", ""Change_of_state_initial_state"", ""purposeful action"", ""Experiencing_a_state"", ""Process"", ""Action"", ""Experiencing a state"", ""experiencing a state""]"	SELF-INITIATED STATE CHANGE IS SELF-PROPELLED MOTION
"[""Self propelled motion"", ""manner of movement"", ""Affected motion"", ""Causation"", ""Complex_process""]"	"[""Action"", ""manner of action"", ""Process""]"	MANNER OF ACTION IS MANNER OF MOVEMENT
"[""Self propelled motion"", ""self-propelled motion along a path"", ""Affected motion"", ""Motion_along_a_path"", ""motion along a path"", ""Causation"", ""Motion"", ""motion"", ""Complex_process"", ""Process""]"	"[""Action"", ""action"", ""Process""]"	ACTION IS SELF-PROPELLED MOTION ALONG A PATH
"[""Sentence"", ""sentences"", ""Linguistic_activity"", ""linguistic activity""]"	"[""Idea"", ""complex ideas"", ""Cognizing"", ""thinking""]"	COMPLEX IDEAS ARE SENTENCES
"[""Separation"", ""division"", ""Separating"", ""Becoming separated""]"	"[""Argument"", ""disagreement"", ""Quarreling"", ""Reasoning""]"	DISAGREEMENT IS DIVISION
"[""Servant"", ""servant"", ""Person"", ""person"", ""Animate entity"", ""Sentient entity"", ""Biological entity"", ""organism"", ""Entity"", ""Complex physical object"", ""Object"", ""Bounded entity"", ""Physical entity""]"	"[""Government"", ""government"", ""Organization"", ""Social group"", ""Group""]"	GOVERNMENT IS A SERVANT
"[""Servitude"", ""slavery"", ""Physical harm"", ""causing harm"", ""Harm"", ""Causation"", ""Complex_process""]"	"[""Taxation"", ""taxation"", ""Governing action"", ""Purposeful action"", ""Action"", ""Process""]"	TAXATION IS SLAVERY
"[""Servitude"", ""slaves""]"	"[""Nation"", ""citizens"", ""Political region""]"	CITIZENS ARE SLAVES
"[""Shepherding"", ""shepherd"", ""People_by_vocation"", ""Work scenario"", ""Person"", ""person"", ""Animate entity"", ""Sentient entity"", ""Biological entity"", ""organism"", ""Entity"", ""Complex physical object"", ""Object"", ""Bounded entity"", ""Physical entity""]"	"[""Government"", ""government"", ""Organization"", ""Social group"", ""Group""]"	GOVERNMENT IS A SHEPHERD
"[""Size"", ""big""]"	"[""Quantity"", ""more""]"	MORE IS BIG
"[""Size"", ""size of object""]"	"[""State"", ""amount of state""]"	AMOUNT OF STATE IS SIZE OF OBJECT
"[""Size"", ""size""]"	"[""Importance"", ""importance""]"	IMPORTANCE IS SIZE
"[""Size"", ""size""]"	"[""Poverty"", ""amount of poverty"", ""Economic status"", ""Social problems"", ""State"", ""amount of state"", ""Social group"", ""Status"", ""Problem"", ""Group""]"	AMOUNT OF POVERTY IS SIZE
"[""Size"", ""size""]"	"[""Problem"", ""amount of problem"", ""Predicament""]"	AMOUNT OF PROBLEM IS SIZE
"[""Size"", ""size""]"	"[""Quantity"", ""quantity""]"	QUANTITY IS SIZE
"[""Size"", ""small""]"	"[""Quantity"", ""less""]"	LESS IS SMALL
"[""Smelling"", ""smelling""]"	"[""Perception"", ""sensing""]"	SENSING IS SMELLING
"[""Source path goal"", ""different available paths"", ""Source_path_goal"", ""Trajector landmark"", ""Figure ground"", ""Spatial relation""]"	"[""Decision_making"", ""alternatives""]"	ALTERNATIVES ARE DIFFERENT AVAILABLE PATHS
"[""Source path goal"", ""paths"", ""Trajector landmark"", ""Figure ground"", ""Spatial relation""]"	"[""Scale"", ""scales"", ""State""]"	SCALES ARE PATHS
"[""Source path goal"", ""prevented change of location"", ""Trajector landmark"", ""Figure ground"", ""Spatial relation""]"	"[""Change of state"", ""prevented change of state"", ""Experiencing_a_state"", ""Process""]"	PREVENTED CHANGE OF STATE IS PREVENTED CHANGE OF LOCATION
"[""Space"", ""physical space""]"	"[""Perception"", ""nonvisual perceptual space""]"	NONVISUAL PERCEPTUAL SPACE IS PHYSICAL SPACE
"[""Spatial relation"", ""spatial relation with an entity""]"	"[""Experiencing a state"", ""experience of a state""]"	EXPERIENCE OF A STATE IS SPATIAL RELATION WITH AN ENTITY
"[""Speaking"", ""speaking"", ""Communication"", ""Linguistic_activity"", ""linguistic activity""]"	"[""Cognizing"", ""thinking""]"	THINKING IS SPEAKING
"[""Speaking"", ""speaking"", ""Speak_on_topic"", ""Communication""]"	"[""Voting"", ""voting"", ""Government decision making"", ""Governing action"", ""Decision making"", ""Purposeful action"", ""Action"", ""Process""]"	VOTING IS SPEAKING
"[""Spelling"", ""spelling"", ""Linguistic_activity"", ""linguistic activity""]"	"[""Communication"", ""fully communicating a sequence of thought"", ""Cognizing"", ""thinking""]"	FULLY COMMUNICATING A SEQUENCE OF THOUGHT IS SPELLING
"[""Steering a boat"", ""steering a boat"", ""Vehicular motion"", ""driving a vehicle"", ""Affected motion"", ""Causation"", ""Complex_process"", ""Guided motion"", ""guided motion along a path"", ""Forced motion"", ""force moving an object forward""]"	"[""State leadership"", ""leading a nation"", ""Leadership"", ""leading a group"", ""Action"", ""guided action"", ""Process""]"	LEADING A NATION IS STEERING A BOAT
"[""Stop airflow"", ""suffocation"", ""Harm to living entity"", ""Physical harm"", ""Harm"", ""Causation"", ""Complex_process""]"	"[""Regulation"", ""government regulation""]"	GOVERNMENT REGULATION IS SUFFOCATION
"[""Straight_path"", ""straight path""]"	"[""Morality"", ""morality""]"	MORALITY IS A STRAIGHT PATH
"[""Straightness"", ""crooked""]"	"[""Morality"", ""immoral""]"	IMMORAL IS CROOKED
"[""Straightness"", ""straight""]"	"[""Morality"", ""moral""]"	MORAL IS STRAIGHT
"[""Straightness"", ""straightness""]"	"[""Morality"", ""morality""]"	MORALITY IS STRAIGHTNESS
"[""Strict father family"", ""strict father family"", ""Nuclear family"", ""Family"", ""family"", ""Social group"", ""Group""]"	"[""Laissez-faire market"", ""laissez-faire market"", ""Market"", ""market"", ""Institution"", ""Organization"", ""Social group"", ""Group""]"	LAISSEZ-FAIRE MARKET IS A STRICT FATHER FAMILY
"[""Strict father family"", ""strict father"", ""Nuclear family"", ""Agentive causation"", ""agent"", ""Family"", ""Social group"", ""Group""]"	"[""Nature"", ""nature""]"	NATURE IS A STRICT FATHER
"[""Substance"", ""substance"", ""physical entity"", ""entity""]"	"[""Time"", ""time""]"	TIME IS A SUBSTANCE
"[""Substance"", ""substance"", ""physical entity""]"	"[""Money"", ""money"", ""Financial resource"", ""Resource""]"	MONEY IS A SUBSTANCE
"[""Substance"", ""substance"", ""physical entity""]"	"[""Wealth"", ""wealth"", ""Economic status"", ""Social group"", ""Status"", ""Group""]"	WEALTH IS A SUBSTANCE
"[""Substance"", ""substances"", ""physical entity""]"	"[""Emotion"", ""emotions"", ""Experiencing a state""]"	EMOTIONS ARE SUBSTANCES
"[""Substance"", ""substances"", ""physical entity""]"	"[""Quality"", ""qualities""]"	QUALITIES ARE SUBSTANCES
"[""Support"", ""physical support""]"	"[""Aids to action"", ""help""]"	HELP IS PHYSICAL SUPPORT
"[""Support"", ""support""]"	"[""Assistance"", ""assistance""]"	ASSISTANCE IS SUPPORT
"[""Support"", ""support""]"	"[""Assistance"", ""government assistance"", ""assistance""]"	GOVERNMENT ASSISTANCE IS SUPPORT
"[""System"", ""system""]"	"[""Nation"", ""nation"", ""Political region""]"	NATION IS A SYSTEM
"[""Taste"", ""taste"", ""Tasting"", ""Perception""]"	"[""Personal_preferance"", ""personal preference""]"	PERSONAL PREFERENCE IS TASTE
"[""Temperature"", ""cold""]"	"[""Emotional intensity"", ""emotionally indifferent"", ""Emotion"", ""Experiencing a state""]"	EMOTIONALLY INDIFFERENT IS COLD
"[""Temperature"", ""experiencing mild temperature""]"	"[""Emotional intensity"", ""emotionally mild"", ""Emotion"", ""Experiencing a state""]"	EMOTIONALLY MILD IS EXPERIENCING MILD TEMPERATURE
"[""Tending to plants"", ""growing a plant""]"	"[""Law"", ""creating a law""]"	CREATING A LAW IS GROWING A PLANT
"[""Tending to plants"", ""trimming a plant""]"	"[""Law"", ""refining a law""]"	REFINING A LAW IS TRIMMING A PLANT
"[""Territory"", ""territories"", ""Bounded region"", ""Region""]"	"[""Rights"", ""citizen rights"", ""rights""]"	CITIZEN RIGHTS ARE TERRITORIES
"[""Territory"", ""territories"", ""Bounded region"", ""Region""]"	"[""Rights"", ""rights""]"	RIGHTS ARE TERRITORIES
"[""Textile"", ""cloth"", ""Physical structure"", ""Complex physical object"", ""Object"", ""Bounded entity"", ""Physical entity"", ""Entity""]"	"[""Marriage"", ""marriage"", ""Relationship""]"	MARRIAGE IS CLOTH
"[""Textile"", ""fabric"", ""Physical structure"", ""Complex physical object"", ""Object"", ""Bounded entity"", ""Physical entity"", ""Entity""]"	"[""Social group"", ""social group"", ""Group""]"	SOCIAL GROUP IS A FABRIC
"[""Theft"", ""theft"", ""Crime""]"	"[""government's harmful treatment of rights""]"	GOVERNMENT'S HARMFUL TREATMENT OF RIGHTS IS THEFT
"[""Theft"", ""theft"", ""Robbery"", ""Crime"", ""Physical harm"", ""causing harm"", ""Harm"", ""Causation"", ""Complex_process""]"	"[""Taxation"", ""taxation"", ""Governing action"", ""Purposeful action"", ""Action"", ""Process""]"	TAXATION IS THEFT
"[""Ticket"", ""tickets to a destination"", ""Aids to motion"", ""Enablement""]"	"[""Aids to action"", ""aids to improving economic status"", ""aids to achieving a purpose""]"	AIDS TO IMPROVING ECONOMIC STATUS ARE TICKETS TO A DESTINATION
"[""Touching"", ""touching"", ""Manipulation"", ""Locative_relation"", ""Perception""]"	"[""Seeing"", ""seeing"", ""Perception""]"	SEEING IS TOUCHING
"[""Touching"", ""touching"", ""Perception"", ""perceiving"", ""Cognizing"", ""bodily functioning""]"	"[""Knowing"", ""knowing"", ""Cognizing""]"	KNOWING IS TOUCHING
"[""Trajector landmark"", ""locations"", ""Trajector-Landmark"", ""Figure ground"", ""Spatial relation""]"	"[""State"", ""states""]"	STATES ARE LOCATIONS
"[""Trajector landmark"", ""proximate object"", ""Figure ground"", ""Spatial relation"", ""spatial relation with an entity""]"	"[""Experiencing a state"", ""experienced state""]"	EXPERIENCED STATE IS A PROXIMATE OBJECT
"[""Transfer scenario"", ""object transfer"", ""Complex process""]"	"[""Causation"", ""causation"", ""Complex_process""]"	CAUSATION IS OBJECT TRANSFER
"[""Transfer scenario"", ""object transfer"", ""Complex process""]"	"[""Communication"", ""communicating""]"	COMMUNICATING IS OBJECT TRANSFER
"[""Transfer scenario"", ""object transfer"", ""Transfer_scenario"", ""Transfer"", ""Complex process""]"	"[""Force transfer"", ""force transfer""]"	FORCE TRANSFER IS OBJECT TRANSFER
"[""Transfer scenario"", ""transfer of possession"", ""Complex process""]"	"[""Control"", ""change in controller"", ""Complex process""]"	CHANGE IN CONTROLLER IS TRANSFER OF POSSESSION
"[""Transfer scenario"", ""transferred objects"", ""Complex process""]"	"[""Causation"", ""effects"", ""Complex_process""]"	EFFECTS ARE TRANSFERRED OBJECTS
"[""Treating a physical affliction"", ""treating a physical affliction"", ""Health treatment""]"	"[""Addressing social problems"", ""addressing social problems"", ""Causation"", ""Complex_process""]"	ADDRESSING SOCIAL PROBLEMS IS TREATING A PHYSICAL AFFLICTION
"[""Treating a physical affliction"", ""treating an illness"", ""Health treatment"", ""treating a physical affliction""]"	"[""Addressing social problems"", ""addressing social problems"", ""Causation"", ""Complex_process""]"	ADDRESSING SOCIAL PROBLEMS IS TREATING AN ILLNESS
"[""Treating a physical affliction"", ""treating an illness"", ""Health treatment""]"	"[""Addressing poverty"", ""addressing poverty"", ""Addressing social problems"", ""addressing social problems"", ""Causation"", ""Complex_process""]"	ADDRESSING POVERTY IS TREATING AN ILLNESS
"[""Treating a physical affliction"", ""treating an illness"", ""Health treatment""]"	"[""Addressing social problems"", ""addressing economic problems"", ""Causation"", ""addressing social problems"", ""Complex_process""]"	ADDRESSING ECONOMIC PROBLEMS IS TREATING AN ILLNESS
"[""Trespassing"", ""invading a territory"", ""Invading"", ""Crime""]"	"[""Rights"", ""government's harmful treatment of rights""]"	GOVERNMENT'S HARMFUL TREATMENT OF RIGHTS IS INVADING A TERRITORY
"[""Upright posture"", ""being upright"", ""Verticality"", ""State""]"	"[""Moral goodness"", ""being good""]"	BEING GOOD IS BEING UPRIGHT
"[""Upright_posture"", ""uprightness""]"	"[""Morality"", ""morality""]"	MORALITY IS UPRIGHTNESS
"[""Upward motion"", ""moving upwards"", ""Motion along a path"", ""Motion"", ""Process""]"	"[""Power"", ""achieving power""]"	ACHIEVING POWER IS MOVING UPWARDS
"[""Upward motion"", ""upward motion"", ""Motion along a path"", ""change of location"", ""Motion"", ""Being at a location"", ""being at a location"", ""Process"", ""Trajector landmark"", ""Spatial relation"", ""spatial relation with an entity"", ""Figure ground""]"	"[""Improving economic status"", ""improving economic status"", ""Change of state"", ""Improving a state"", ""change of state"", ""Experiencing_a_state"", ""Process"", ""Experiencing a state"", ""experiencing a state""]"	IMPROVING ECONOMIC STATUS IS UPWARD MOTION
"[""Upward motion"", ""upward motion"", ""Motion along a path"", ""Motion"", ""Process""]"	"[""Emotion"", ""improvement in mood"", ""Experiencing a state""]"	IMPROVEMENT IN MOOD IS UPWARD MOTION
"[""Upward motion"", ""upward motion"", ""Motion along a path"", ""Motion"", ""Process""]"	"[""Quantity"", ""increase in quantity""]"	INCREASE IN QUANTITY IS UPWARD MOTION
"[""Vehicle"", ""vehicle"", ""Machine"", ""Mode_of_transportation"", ""Complex physical object"", ""complex structure"", ""Physical structure"", ""Object"", ""Bounded entity"", ""Physical entity"", ""Entity""]"	"[""Nation"", ""nation"", ""Political region""]"	NATION IS A VEHICLE
"[""Vehicle"", ""vehicle"", ""Machine"", ""Mode_of_transportation"", ""machine"", ""Physical structure"", ""Complex physical object"", ""complex physical object"", ""Object"", ""Bounded entity"", ""Physical entity"", ""Entity""]"	"[""Institution"", ""institution"", ""Organization"", ""Social group"", ""Group""]"	INSTITUTION IS A VEHICLE
"[""Vehicle"", ""vehicle"", ""Machine"", ""Mode_of_transportation"", ""Physical structure"", ""Complex physical object"", ""Object"", ""Bounded entity"", ""Physical entity"", ""Entity""]"	"[""Political region"", ""political region"", ""Political_locales"", ""Institution"", ""institution"", ""Institutions"", ""Organization"", ""Social group"", ""Group""]"	POLITICAL REGION IS A VEHICLE
"[""Vehicle"", ""vehicles"", ""Machine"", ""Mode_of_transportation"", ""Containing"", ""containers"", ""Physical structure"", ""Object"", ""objects"", ""Complex physical object"", ""Bounded entity"", ""Physical entity"", ""Entity""]"	"[""Romantic_relationship"", ""romantic relationships""]"	ROMANTIC RELATIONSHIPS ARE VEHICLES
"[""Vehicular motion"", ""driver"", ""Affected motion"", ""Person"", ""person"", ""Causation"", ""Animate entity"", ""Sentient entity"", ""Biological entity"", ""organism"", ""Complex_process"", ""Entity"", ""Complex physical object"", ""Object"", ""Bounded entity"", ""Physical entity""]"	"[""Governing action"", ""government"", ""Purposeful action"", ""Action"", ""Process""]"	GOVERNMENT IS A DRIVER
"[""Vehicular motion"", ""driving a vehicle"", ""Affected motion"", ""Causation"", ""Complex_process""]"	"[""State leadership"", ""leading a nation"", ""Leadership""]"	LEADING A NATION IS DRIVING A VEHICLE
"[""Vehicular motion"", ""driving a vehicle"", ""Affected motion"", ""Guided motion"", ""guided motion along a path"", ""Forced motion"", ""force moving an object forward"", ""Causation"", ""Complex_process""]"	"[""Leadership"", ""leading a group"", ""Action"", ""guided action"", ""Process""]"	LEADING A GROUP IS DRIVING A VEHICLE
"[""Vertical position"", ""being on the same vertical level""]"	"[""Equality"", ""equality""]"	EQUALITY IS BEING ON THE SAME VERTICAL LEVEL
"[""Vertical_structure"", ""vertical structure""]"	"[""Hierarchy"", ""hierarchy""]"	HIERARCHY IS A VERTICAL STRUCTURE
"[""Verticality"", ""being low""]"	"[""Morality"", ""being immoral""]"	BEING IMMORAL IS BEING LOW
"[""Verticality"", ""down""]"	"[""Consciousness"", ""unconscious"", ""Being_awake""]"	UNCONSCIOUS IS DOWN
"[""Verticality"", ""down""]"	"[""Control"", ""subjugation"", ""Complex process""]"	SUBJUGATION IS DOWN
"[""Verticality"", ""down""]"	"[""Quantity"", ""less""]"	LESS IS DOWN
"[""Verticality"", ""down""]"	"[""Status"", ""low status""]"	LOW STATUS IS DOWN
"[""Verticality"", ""physical height""]"	"[""Morality"", ""degree of morality""]"	DEGREE OF MORALITY IS PHYSICAL HEIGHT
"[""Verticality"", ""up""]"	"[""Consciousness"", ""conscious""]"	CONSCIOUS IS UP
"[""Verticality"", ""up""]"	"[""Control"", ""control"", ""Complex process""]"	CONTROL IS UP
"[""Verticality"", ""up""]"	"[""Quantity"", ""more""]"	MORE IS UP
"[""Verticality"", ""up""]"	"[""Status"", ""high status""]"	HIGH STATUS IS UP
"[""Verticality"", ""verticality""]"	"[""Consciousness"", ""consciousness""]"	CONSCIOUSNESS IS VERTICALITY
"[""Verticality"", ""verticality""]"	"[""Control"", ""control"", ""Complex process""]"	CONTROL IS VERTICALITY
"[""Verticality"", ""verticality""]"	"[""Emotion"", ""happiness"", ""Experiencing a state""]"	HAPPINESS IS VERTICALITY
"[""Verticality"", ""verticality""]"	"[""Functionality"", ""functionality""]"	FUNCTIONALITY IS VERTICALITY
"[""Verticality"", ""verticality""]"	"[""Goodness"", ""goodness""]"	GOODNESS IS VERTICALITY
"[""Verticality"", ""verticality""]"	"[""Government institution"", ""government functionality"", ""Institution"", ""Functionality"", ""functionality"", ""Being_operational"", ""Organization"", ""Social group"", ""Group""]"	GOVERNMENT FUNCTIONALITY IS VERTICALITY
"[""Verticality"", ""verticality""]"	"[""Government"", ""government control"", ""Organization"", ""Social group"", ""Group""]"	GOVERNMENT CONTROL IS VERTICALITY
"[""Verticality"", ""verticality""]"	"[""Health"", ""health"", ""Well-being"", ""well-being""]"	HEALTH IS VERTICALITY
"[""Verticality"", ""verticality""]"	"[""Life cycle"", ""life"", ""Cycle_of_life_and_death"", ""Dead_or_alive"", ""Cycle""]"	LIFE IS VERTICALITY
"[""Verticality"", ""verticality""]"	"[""Physical_strength"", ""physical strength""]"	PHYSICAL STRENGTH IS VERTICALITY
"[""Verticality"", ""verticality""]"	"[""Positivity scale"", ""positivity""]"	POSITIVITY IS VERTICALITY
"[""Verticality"", ""verticality""]"	"[""Quantity"", ""quantity""]"	QUANTITY IS VERTICALITY
"[""Verticality"", ""verticality""]"	"[""Status"", ""status""]"	STATUS IS VERTICALITY
"[""Verticality"", ""verticality""]"	"[""Well-being"", ""well-being""]"	WELL-BEING IS VERTICALITY
"[""Visual evaluation"", ""visibility"", ""Evaluation""]"	"[""Existence"", ""existence"", ""Process""]"	EXISTENCE IS VISIBILITY
"[""Visual obstruction"", ""facade"", ""physical entity""]"	"[""Democracy"", ""democracy""]"	DEMOCRACY IS A FACADE
"[""Visual obstruction"", ""visual obstructions""]"	"[""Knowing"", ""difficulties in knowing"", ""Cognizing""]"	DIFFICULTIES IN KNOWING ARE VISUAL OBSTRUCTIONS
"[""War"", ""losing a war"", ""Physical competition"", ""Competition""]"	"[""Election"", ""losing an election"", ""Political competition"", ""Competition""]"	LOSING AN ELECTION IS LOSING A WAR
"[""War"", ""waging war"", ""Physical competition"", ""Competition""]"	"[""Injurious gun use"", ""addressing gun violence"", ""Social problems"", ""Harm to living entity"", ""Addressing social problems"", ""addressing social problems"", ""Problem"", ""Physical harm"", ""Causation"", ""Negatively evaluated condition"", ""negatively evaluated conditions"", ""Harm"", ""Complex_process"", ""State""]"	ADDRESSING GUN VIOLENCE IS WAGING WAR
"[""War"", ""waging war"", ""Physical competition"", ""Harm"", ""harmful agents"", ""Competition"", ""Causation"", ""Complex_process""]"	"[""Addressing social problems"", ""addressing social problems"", ""Causation"", ""Negatively evaluated condition"", ""negatively evaluated conditions"", ""Complex_process"", ""State""]"	ADDRESSING SOCIAL PROBLEMS IS WAGING WAR
"[""War"", ""war"", ""Physical competition"", ""Competition"", ""Physical combat"", ""physical combat"", ""Hostile_encounter"", ""physical conflict""]"	"[""Diplomacy"", ""diplomacy""]"	DIPLOMACY IS WAR
"[""War"", ""war"", ""Physical competition"", ""Competition""]"	"[""Cancer treatment"", ""cancer treatment"", ""Disease treatment"", ""disease treatment"", ""Treating a physical affliction"", ""Health treatment""]"	CANCER TREATMENT IS WAR
"[""War"", ""war"", ""Physical competition"", ""Competition""]"	"[""Disease treatment"", ""disease treatment"", ""Medical_interaction_scenario"", ""Treating a physical affliction"", ""Health treatment""]"	DISEASE TREATMENT IS WAR
"[""War"", ""war"", ""Physical competition"", ""Competition""]"	"[""Election"", ""election"", ""Political competition"", ""Competition""]"	ELECTION IS WAR
"[""War"", ""war"", ""Physical competition"", ""Physical combat"", ""physical combat"", ""Competition"", ""physical conflict""]"	"[""Argument"", ""argument""]"	ARGUMENT IS WAR
"[""War"", ""winning a war"", ""Hostile_encounter"", ""Physical competition"", ""Competition""]"	"[""Election"", ""winning an election"", ""Political competition"", ""Competition""]"	WINNING AN ELECTION IS WINNING A WAR
"[""Water Confinement"", ""water confinement"", ""Confinement"", ""Motion impediments"", ""impediments to movement"", ""Motion-affecting properties of the landscape"", ""Impediment to motion"", ""Motion-affecting external factors"", ""Affected motion"", ""Causation"", ""Complex_process""]"	"[""Improving economic status"", ""impediments to improving economic status"", ""Change of state"", ""Improving a state"", ""Difficulties in action"", ""difficulties"", ""Experiencing_a_state"", ""Process""]"	IMPEDIMENTS TO IMPROVING ECONOMIC STATUS IS WATER CONFINEMENT
"[""Wealth"", ""wealth"", ""Economic status"", ""Social group"", ""Status"", ""Group""]"	"[""Well-being"", ""well-being""]"	WELL-BEING IS WEALTH
"[""Weed"", ""weed"", ""Plants"", ""plant"", ""Biological entity"", ""Complex physical object"", ""Object"", ""Bounded entity"", ""Physical entity"", ""Entity""]"	"[""Poverty"", ""poverty"", ""Economic status"", ""Social problems"", ""Social group"", ""Status"", ""Problem"", ""Group""]"	POVERTY IS A WEED
"[""Weighing"", ""weighing""]"	"[""Decision making"", ""making a decision""]"	MAKING A DECISION IS WEIGHING
"[""Weight"", ""heaviness""]"	"[""Difficulties in action"", ""difficulty""]"	DIFFICULTY IS HEAVINESS
"[""Word"", ""words"", ""Linguistic_activity"", ""linguistic activity""]"	"[""Idea"", ""simple ideas"", ""Cognizing"", ""thinking""]"	SIMPLE IDEAS ARE WORDS
"[""Work scenario"", ""policeman"", ""Person"", ""person"", ""Animate entity"", ""Sentient entity"", ""Biological entity"", ""organism"", ""Entity"", ""Complex physical object"", ""Object"", ""Bounded entity"", ""Physical entity""]"	"[""Government"", ""government"", ""Organization"", ""Social group"", ""Group""]"	GOVERNMENT IS A POLICEMAN
"[""Work scenario"", ""slave master"", ""Person"", ""person"", ""Animate entity"", ""Sentient entity"", ""Biological entity"", ""organism"", ""Entity"", ""Complex physical object"", ""Object"", ""Bounded entity"", ""Physical entity""]"	"[""Government"", ""government"", ""Organization"", ""Social group"", ""Group""]"	GOVERNMENT IS A SLAVE MASTER
"[""Worship"", ""objects of worship"", ""Psychological fixation"", ""targets of psychological fixation""]"	"[""Gun possession"", ""guns"", ""Possession""]"	GUNS ARE OBJECTS OF WORSHIP
"[""Writing"", ""writing"", ""Linguistic_activity"", ""linguistic activity""]"	"[""Memorization"", ""memorization"", ""Cognizing"", ""thinking""]"	MEMORIZATION IS WRITING
"[""Zealotry"", ""zealotry""]"	"[""Gun control"", ""advocating gun control"", ""Control"", ""Complex process""]"	ADVOCATING GUN CONTROL IS ZEALOTRY
"[""addictive drug""]"	"[""government assistance""]"	GOVERNMENT ASSISTANCE IS AN ADDICTIVE DRUG
"[""battlefield""]"	"[""national politics""]"	NATIONAL POLITICS IS A BATTLEFIELD
"[""being on different vertical levels""]"	"[""inequality""]"	INEQUALITY IS BEING ON DIFFERENT VERTICAL LEVELS
"[""blood""]"	"[""household income""]"	HOUSEHOLD INCOME IS BLOOD
"[""breaking a physical object""]"	"[""illegal activity""]"	ILLEGAL ACTIVITY IS BREAKING A PHYSICAL OBJECT
"[""building erosion""]"	"[""national infrastructure deterioration""]"	NATIONAL INFRASTRUCTURE DETERIORATION IS BUILDING EROSION
"[""building maintenance""]"	"[""national infrustructure maintenance""]"	NATIONAL INFRUSTRUCTURE MAINTENANCE IS BUILDING MAINTENANCE
"[""building""]"	"[""national infrastructure""]"	NATIONAL INFRASTRUCTURE IS A BUILDING
"[""complex structure"", ""Physical structure"", ""physical structure"", ""Complex physical object"", ""Object"", ""Bounded entity"", ""Physical entity"", ""Entity""]"	"[""life"", ""Organization"", ""organization"", ""Social group"", ""Group""]"	LIFE IS A COMPLEX STRUCTURE
"[""connection""]"	"[""international association""]"	INTERNATIONAL ASSOCIATION IS CONNECTION
"[""defending a territory""]"	"[""government's positive treatment of rights""]"	GOVERNMENT'S POSITIVE TREATMENT OF RIGHTS IS DEFENDING A TERRITORY
"[""dirty object""]"	"[""negatively evaluated government activity""]"	NEGATIVELY EVALUATED GOVERNMENT ACTIVITY IS DIRTY OBJECT
"[""disgust""]"	"[""negative evaluation of government activity""]"	NEGATIVE EVALUATION OF GOVERNMENT ACTIVITY IS DISGUST
"[""disgusting object""]"	"[""negatively evaluated government activity""]"	NEGATIVELY EVALUATED GOVERNMENT ACTIVITY IS DISGUSTING OBJECT
"[""handout""]"	"[""government assistance""]"	GOVERNMENT ASSISTANCE IS A HANDOUT
"[""head of body""]"	"[""leader of a nation""]"	LEADER OF A NATION IS HEAD OF BODY
"[""head of body""]"	"[""leader of group""]"	LEADER OF GROUP IS HEAD OF BODY
"[""inability to see""]"	"[""inability to evaluate government""]"	INABILITY TO EVALUATE GOVERNMENT IS INABILITY TO SEE
"[""increasing light""]"	"[""increasing evaluability of government""]"	INCREASING EVALUABILITY OF GOVERNMENT IS INCREASING LIGHT
"[""increasing transparency""]"	"[""increasing evaluability of government""]"	INCREASING EVALUABILITY OF GOVERNMENT IS INCREASING TRANSPARENCY
"[""leaders""]"	"[""influential nations""]"	INFLUENTIAL NATIONS ARE LEADERS
"[""measuring""]"	"[""governmental assessing""]"	GOVERNMENTAL ASSESSING IS MEASURING
"[""neighbors""]"	"[""nearby countries""]"	NEARBY COUNTRIES ARE NEIGHBORS
"[""outlaws""]"	"[""nations not abiding by international law""]"	NATIONS NOT ABIDING BY INTERNATIONAL LAW ARE OUTLAWS
"[""partners""]"	"[""government and citizens""]"	GOVERNMENT AND CITIZENS ARE PARTNERS
"[""physical proximity""]"	"[""governmental agreement""]"	GOVERNMENTAL AGREEMENT IS PHYSICAL PROXIMITY
"[""quarrels""]"	"[""international disagreements""]"	INTERNATIONAL DISAGREEMENTS ARE QUARRELS
"[""resource""]"	"[""money""]"	MONEY IS A RESOURCE
"[""rising water level""]"	"[""increasing government debt""]"	INCREASING GOVERNMENT DEBT IS RISING WATER LEVEL
"[""sleeping""]"	"[""government inaction""]"	GOVERNMENT INACTION IS SLEEPING
"[""sports field""]"	"[""national politics""]"	NATIONAL POLITICS IS A SPORTS FIELD
"[""sports referees""]"	"[""judges""]"	JUDGES ARE SPORTS REFEREES
"[""sports teams""]"	"[""political parties""]"	POLITICAL PARTIES ARE SPORTS TEAMS
"[""stage actors""]"	"[""politicians""]"	POLITICIANS ARE STAGE ACTORS
"[""stage""]"	"[""national politics""]"	NATIONAL POLITICS IS A STAGE
"[""strengthening an object""]"	"[""government's positive treatment of rights""]"	GOVERNMENT'S POSITIVE TREATMENT OF RIGHTS IS STRENGTHENING AN OBJECT
"[""supporting a physical structure""]"	"[""government's positive treatment of rights""]"	GOVERNMENT'S POSITIVE TREATMENT OF RIGHTS IS SUPPORTING A PHYSICAL STRUCTURE
"[""supporting a structure""]"	"[""law enforcement""]"	LAW ENFORCEMENT IS SUPPORTING A STRUCTURE
"[""toppling a physical object""]"	"[""revolution""]"	REVOLUTION IS TOPPLING A PHYSICAL OBJECT
"[""trampling on an object""]"	"[""government's harmful treatment of rights""]"	GOVERNMENT'S HARMFUL TREATMENT OF RIGHTS IS TRAMPLING ON AN OBJECT
"[""transparency""]"	"[""public evaluability of govermnent""]"	PUBLIC EVALUABILITY OF GOVERMNENT IS TRANSPARENCY
"[""trespassing""]"	"[""government's harmful treatment of rights""]"	GOVERNMENT'S HARMFUL TREATMENT OF RIGHTS IS TRESPASSING
"[""wildfire""]"	"[""political unrest""]"	POLITICAL UNREST IS A WILDFIRE
